chai: chaijs@keithcirkel.co.uk, chaijs@keithcirkel.co.uk, 
gulp: ericbombhax@gmail.com, blaine.bublitz@gmail.com, 
lodash: mathias@qiwi.be, john.david.dalton@gmail.com, benjamin@dev.ofcr.se, 
grunt: cowboy@rj3.net, tyler@sleekcode.net, vlad@vladikoff.com, kyle@dontkry.com, 
babel-eslint: daniel@tschinder.de, bng412@gmail.com, hi@henryzoo.com, npm@jameshenry.email, kai@kaicataldo.com, loganfsmyth@gmail.com, monastic.panic@gmail.com, public@mysticatea.dev, nicolo.ribaudo@gmail.com, teddy.katz@gmail.com, npm@sebastian.barretomckenzie.com, zertosh@gmail.com, 
babel-loader: loganfsmyth@gmail.com, npm@tschinder.de, hi@henryzoo.com, bng412@gmail.com, nicolo.ribaudo@gmail.com, 
rimraf: i@izs.me, 
request: fkschott@gmail.com, mikeal.rogers@gmail.com, jnylen@gmail.com, simeonvelichkov@gmail.com, 
async: beau@beaugunderson.com, caolan@caolan.uk, alexander.early@gmail.com, megawac@gmail.com, argasinski.hubert@gmail.com, 
chalk: sindresorhus@gmail.com, josh@junon.me, 
coveralls: gregg@caines.ca, n@mer.fm, 
istanbul: ben@npmjs.com, davglass@gmail.com, kananthmail-github@yahoo.com, 
should: bardadymchik@gmail.com, gjj391@gmail.com, tj@travisjeffery.com, 
grunt-contrib-jshint: cowboy@rj3.net, roaster.karmic_0r@icloud.com, tyler@sleekcode.net, vlad@vladikoff.com, kyle@dontkry.com, sindresorhus@gmail.com, 
underscore: jashkenas@gmail.com, justin+npm@ridgewell.name, dev@juliangonggrijp.com, 
tape: d@domenic.me, substack@gmail.com, raynos2@gmail.com, ljharb@gmail.com, 
eslint-plugin-react: yannick.croissant+npm@gmail.com, ljharb@gmail.com, 
express: mikeal.rogers@gmail.com, doug@somethingdoug.com, jasnell@gmail.com, 
commander: rkoutnik@gmail.com, tj@vision-media.ca, npm_j@ruru.gen.nz, abe@enzou.tokyo, 
eslint-plugin-import: jfm.engels@gmail.com, ljharb@gmail.com, me@benmosher.com, 
coffee-script: computing+npm@geoffreybooth.com, jashkenas@gmail.com, simon.lydell@gmail.com, npm@michael.ficarra.me, 
mkdirp: i@izs.me, 
debug: josh@junon.me, rhyneandrew@gmail.com, nathan@tootallnate.net, tj@vision-media.ca, 
bluebird: petka_antonov@hotmail.com, 
gulp-util: ericbombhax@gmail.com, blaine.bublitz@gmail.com, 
eslint: npm@openjsf.org, nicholas+eslint@nczconsulting.com, nicholas@nczconsulting.com, ivolodin@gmail.com, 
jshint: mike@mikepennisi.com, anton@kovalyov.net, waldron.rick@gmail.com, 
mocha: munter@fumle.dk, boneskull@boneskull.com, filodron@gmail.com, 
css-loader: sheo13666q@gmail.com, tobias.koppers@googlemail.com, mail@johannesewald.de, 
grunt-contrib-watch: cowboy@rj3.net, jellyes2@gmail.com, kyle@dontkry.com, sindresorhus@gmail.com, tyler@sleekcode.net, vlad@vladikoff.com, 
gulp-rename: hector@hectorparra.com, contact@wearefractal.com, snnskwtnb@gmail.com, hector@hectorparra.com, ericbombhax@gmail.com, 
style-loader: sheo13666q@gmail.com, tobias.koppers@googlemail.com, mail@johannesewald.de, 
grunt-contrib-clean: cowboy@rj3.net, roaster.karmic_0r@icloud.com, tyler@sleekcode.net, vlad@vladikoff.com, kyle@dontkry.com, sindresorhus@gmail.com, 
moment: iskren.chernev@gmail.com, washwithcare@gmail.com, mj1856@hotmail.com, maggiepint@gmail.com, marwahaha@berkeley.edu, 
glob: i@izs.me, 
gulp-uglify: terinjokes@gmail.com, 
karma-chrome-launcher: dignifiedquire@gmail.com, mark@zzo.com, vojta.jina+npm@gmail.com, karmarunnerbot@gmail.com, 
del: sindresorhus@gmail.com, 
fs-extra: jprichardson@gmail.com, opensrc@ryanzim.com, manidlou@gmail.com, 
colors: marak.squires@gmail.com, 
browserify: substack@gmail.com, feross@feross.org, me@gkatsev.com, zertosh@gmail.com, mathiasbuus@gmail.com, max@maxogden.com, thlorenz10@gmail.com, terinjokes@gmail.com, npm-public@jessemccarthy.net, palmermebane@gmail.com, darawk@gmail.com, b@lupton.cc, calvin.metcalf@gmail.com, jprichardson@gmail.com, fedor@indutny.com, jryans@gmail.com, sethvincent@gmail.com, yoshuawuyts@gmail.com, ungoldman@gmail.com, michael.williams@enspiral.com, contact@elnounch.net, parshap+npm@gmail.com, yerko.palma@usach.cl, forbes@lindesay.co.uk, martin.heidegger@gmail.com, garann@gmail.com, bcomnes@gmail.com, vestibule@anandthakker.net, dave.des@gmail.com, hughskennedy@gmail.com, pereira.filype@gmail.com, renee@kooi.me, post.ben.here@gmail.com, github@tixz.dk, maochenyan@gmail.com, peteris.krumins@gmail.com, me@JoshDuff.com, shtylman@gmail.com, lukechilds123@gmail.com, raynos2@gmail.com, d@domenic.me, 
sinon: carlerik@gmail.com, christian@cjohansen.no, mail@maxantoni.de, morgan@roderick.dk, 
jquery: dave.methvin@gmail.com, 4timmywil@gmail.com, m.goleb@gmail.com, npm@openjsf.org, 
electron-lite: kaizhu256@gmail.com, 
file-loader: sheo13666q@gmail.com, tobias.koppers@googlemail.com, mail@johannesewald.de, eric@smarterspam.com, michael.ciniawsky@gmail.com, sean.larkin@cuw.edu, 
uglify-js: alexlamsl@gmail.com, mihai.bazon@gmail.com, rvanvelzen1@gmail.com, 
through2: bryce@ravenwall.com, rod@vagg.org, 
gulp-mocha: sindresorhus@gmail.com, 
sinon-chai: d@domenic.me, simondelang@gmail.com, 
karma-jasmine: dignifiedquire@gmail.com, mark@zzo.com, rv.maksim@gmail.com, vojta.jina+npm@gmail.com, karmarunnerbot@gmail.com, 
webpack-dev-server: tobias.koppers@googlemail.com, mail@johannesewald.de, sheo13666q@gmail.com, hello@hiroppy.me, 
grunt-contrib-uglify: cowboy@rj3.net, alexlamsl@gmail.com, roaster.karmic_0r@icloud.com, tyler@sleekcode.net, vlad@vladikoff.com, kyle@dontkry.com, sindresorhus@gmail.com, jsoverson@gmail.com, xhmikosr@gmail.com, 
minimist: substack@gmail.com, github@tixz.dk, 
body-parser: doug@somethingdoug.com, 
standard: john@hiesey.com, bcomnes@gmail.com, feross@feross.org, flettre@gmail.com, linus@folkdatorn.se, mathiasbuus@gmail.com, jprichardson@gmail.com, w@tson.dk, raynos2@gmail.com, toddbluhm@gmail.com, pelle@kodfabrik.se, yoshuawuyts@gmail.com, secoif@gmail.com, max@maxogden.com, npm@dcousens.com, jb55@jb55.com, 
karma-phantomjs-launcher: vojta.jina+npm@gmail.com, mark@zzo.com, dignifiedquire@gmail.com, karmarunnerbot@gmail.com, 
extract-text-webpack-plugin: sheo13666q@gmail.com, tobias.koppers@googlemail.com, mail@johannesewald.de, michael.ciniawsky@gmail.com, wiens.joshua@gmail.com, eric@smarterspam.com, sean.larkin@cuw.edu, kees@webduck.nl, 
q: kris.kowal@cixar.com, domenic@domenicdenicola.com, 
ava: sindresorhus@gmail.com, mark@novemberborn.net, 
url-loader: sheo13666q@gmail.com, tobias.koppers@googlemail.com, mail@johannesewald.de, michael.ciniawsky@gmail.com, sean.larkin@cuw.edu, 
gulp-babel: daniel@tschinder.de, demurgos@demurgos.net, bng412@gmail.com, hi@henryzoo.com, loganfsmyth@gmail.com, sebmck@gmail.com, sindresorhus@gmail.com, 
nyc: ben@npmjs.com, git@cfware.com, i@izs.me, 
gulp-concat: contact@wearefractal.com, ericbombhax@gmail.com, 
eslint-plugin-jsx-a11y: ethanvcohen@gmail.com, splendidnoise@gmail.com, joe.lencioni@gmail.com, ljharb@gmail.com, 
node-sass: npm@saper.info, nschonni@gmail.com, xzyfer@gmail.com, 
gulp-sourcemaps: blaine.bublitz@gmail.com, florian.reiterer@gmail.com, nemtcan@gmail.com, 
tslint: pt-vendor-npm@palantir.com, 
jasmine-core: gwen@slackersoft.net, sdg@panix.com, dwfrank@pivotallabs.com, 
karma-mocha: dignifiedquire@gmail.com, karmarunnerbot@gmail.com, rv.maksim@gmail.com, vojta.jina+npm@gmail.com, mark@zzo.com, 
utility2: kaizhu256@gmail.com, 
grunt-cli: cowboy@rj3.net, tyler@sleekcode.net, vlad@vladikoff.com, kyle@dontkry.com, 
cross-env: me@kentcdodds.com, 
yargs: bencoe@gmail.com, bencoe+oss-bot@gmail.com, 
karma-coverage: dignifiedquire@gmail.com, mark@zzo.com, vojta.jina+npm@gmail.com, karmarunnerbot@gmail.com, 
jshint-stylish: sindresorhus@gmail.com, 
semver: fritzy@github.com, darcy@darcyclarke.me, ruyadorno@hotmail.com, quitlahok@gmail.com, gar+npm@danger.computer, luke@lukekarrys.com, 
shelljs: arturadib@gmail.com, ntfschr@gmail.com, freitagbr@gmail.com, 
cheerio: mattmuelle@gmail.com, dc@davidchambers.me, mike@mikepennisi.com, me@feedic.com, 
json-loader: sheo13666q@gmail.com, tobias.koppers@googlemail.com, mail@johannesewald.de, michael.ciniawsky@gmail.com, wiens.joshua@gmail.com, eric@smarterspam.com, sean.larkin@cuw.edu, 
gulp-eslint: dark.account@gmail.com, snnskwtnb@gmail.com, 
grunt-contrib-nodeunit: cowboy@rj3.net, james_account@icloud.com, tyler@sleekcode.net, vlad@vladikoff.com, kyle@dontkry.com, sindresorhus@gmail.com, 
babelify: loganfsmyth@gmail.com, sebmck@gmail.com, zertosh@gmail.com, 
yeoman-generator: sindresorhus@gmail.com, admin@simonboudrias.com, eddie+npm@eddiemonge.com, addyosmani@gmail.com, mail@michael-kuehnel.de, mehdy.dara.fr@gmail.com, ulisesgascondev@gmail.com, marceloshima@gmail.com, ruyadorno@hotmail.com, npm@paul.irish, 
babel-plugin-add-module-exports: i59naga@icloud.com, lijunle@gmail.com, ljharb@gmail.com, 
karma: dignifiedquire@gmail.com, johnjbarton@johnjbarton.com, mark@zzo.com, vojta.jina+npm@gmail.com, karmarunnerbot@gmail.com, 
supertest: niftylettuce@gmail.com, gjj391@gmail.com, tj@vision-media.ca, oleg008@gmail.com, shtylman@gmail.com, mholtzman@gmail.com, dimitri.dobairro@dimsolution.com, npm@titanism.com, 
gulp-plumber: floatdrop@gmail.com, 
run-sequence: phil@overzealous.com, 
gulp-jshint: contact@wearefractal.com, email@spalger.com, ericbombhax@gmail.com, 
expect.js: rauchg@gmail.com, 
jsdom: timothygu99@gmail.com, d@domenic.me, sebmaster16@gmail.com, code@zirro.se, tmpvar@gmail.com, joris@jorisvanderwel.com, 
eslint-config-standard: john@hiesey.com, bcomnes@gmail.com, feross@feross.org, flettre@gmail.com, linus@folkdatorn.se, mathiasbuus@gmail.com, jprichardson@gmail.com, w@tson.dk, raynos2@gmail.com, toddbluhm@gmail.com, pelle@kodfabrik.se, 
eslint-loader: m@moox.io, 
eslint-plugin-standard: john@hiesey.com, bcomnes@gmail.com, feross@feross.org, flettre@gmail.com, linus@folkdatorn.se, mathiasbuus@gmail.com, jprichardson@gmail.com, w@tson.dk, raynos2@gmail.com, toddbluhm@gmail.com, pelle@kodfabrik.se, jamund@gmail.com, 
karma-webpack: sheo13666q@gmail.com, tobias.koppers@googlemail.com, mail@johannesewald.de, ryan@ryanclark.me, 
html-webpack-plugin: j.nicklas@me.com, charles.blaxland@gmail.com, th.sileghem@gmail.com, sean.larkin@cuw.edu, 
object-assign: npm2@sophiebits.com, dan.abramov@gmail.com, sindresorhus@gmail.com, 
load-grunt-tasks: sindresorhus@gmail.com, 
chai-as-promised: domenic@domenicdenicola.com, 
classnames: jed.watson@me.com, npm@dcousens.com, 
eslint-plugin-promise: jamund@gmail.com, macklinu@gmail.com, 
grunt-contrib-copy: tyler@sleekcode.net, cowboy@rj3.net, kyle@dontkry.com, vlad@vladikoff.com, sindresorhus@gmail.com, jellyes2@gmail.com, 
grunt-contrib-concat: cowboy@rj3.net, roaster.karmic_0r@icloud.com, tyler@sleekcode.net, vlad@vladikoff.com, kyle@dontkry.com, sindresorhus@gmail.com, 
autoprefixer: andrey@sitnik.ru, 
sass-loader: sheo13666q@gmail.com, tobias.koppers@googlemail.com, mail@johannesewald.de, 
rxjs: nicholas@cartant.com, ben@benlesh.com, kwon.ohjoong@gmail.com, 
prop-types: dan.abramov@gmail.com, npm@andrewclark.io, ljharb@gmail.com, opensource+npm@fb.com, npm@sophiebits.com, 
grunt-mocha-test: pghalliday@gmail.com, 
zone.js: devops+npm@angular.io, node-team-npm+wombot@google.com, 
enzyme: ljharb@gmail.com, gdborton@gmail.com, leland.m.richardson@gmail.com, 
uuid: robert@broofa.com, dev@tavan.de, shtylman@gmail.com, vincent.voyer@gmail.com, 
less: matthewdean.me@gmail.com, matthewdean.me@gmail.com, seven.phases.max@gmail.com, sommeridevel@gmail.com, calvin.juarez+npm@gmail.com, alexis@cloudhead.io, luke.a.page@gmail.com, 
eslint-config-airbnb-base: opensource@airbnb.com, joe.lencioni@gmail.com, noratarano@gmail.com, ljharb@gmail.com, tosharmila@gmail.com, 
redux: dan.abramov@gmail.com, timdorr@timdorr.com, npm@andrewclark.io, mark.erikson@gmail.com, 
vinyl-source-stream: blaine.bublitz@gmail.com, hughskennedy@gmail.com, 
gulp-istanbul: admin@simonboudrias.com, 
postcss-loader: sheo13666q@gmail.com, tobias.koppers@googlemail.com, mail@johannesewald.de, andrey@sitnik.ru, 
jasmine: gwen@slackersoft.net, sdg@panix.com, dwfrank@pivotallabs.com, chris.amavisca@gmail.com, 
xo: sindresorhus@gmail.com, 
karma-sourcemap-loader: gabriele.genta@gmail.com, 
core-js: zloirock@zloirock.ru, 
karma-firefox-launcher: dignifiedquire@gmail.com, mark@zzo.com, vojta.jina+npm@gmail.com, karmarunnerbot@gmail.com, 
winston: chjjeffrey@gmail.com, jcrugzz@gmail.com, npm@3rd-Eden.com, charlie.robbins@gmail.com, npmjs@3rd-Eden.com, dabh@alumni.stanford.edu, wbt@alumni.cmu.edu, 
phantomjs-prebuilt: npm@medium.com, unagicat@yahoo.com, nhall@medium.com, 
pre-commit: npm@3rd-Eden.com, npm@3rd-Eden.com, info@martijnswaagman.nl, 
co: tj@vision-media.ca, jonathanrichardong@gmail.com, jonathanrichardong@gmail.com, 
gulp-sass: dlmanning@me.com, sam@snug.ug, xzyfer@gmail.com, 
inquirer: admin@simonboudrias.com, chatfielddaniel@gmail.com, mail@michael-kuehnel.de, ruyadorno@hotmail.com, 
node-uuid: robert@broofa.com, shtylman@gmail.com, 
optimist: substack@gmail.com, alex.ford@codetunnel.com, ben@npmjs.com, 
es6-promise: jaffathecake@gmail.com, stefan.penner@gmail.com, 
watchify: substack@gmail.com, feross@feross.org, me@gkatsev.com, zertosh@gmail.com, mathiasbuus@gmail.com, max@maxogden.com, thlorenz10@gmail.com, terinjokes@gmail.com, npm-public@jessemccarthy.net, palmermebane@gmail.com, darawk@gmail.com, b@lupton.cc, calvin.metcalf@gmail.com, jprichardson@gmail.com, fedor@indutny.com, jryans@gmail.com, sethvincent@gmail.com, yoshuawuyts@gmail.com, ungoldman@gmail.com, michael.williams@enspiral.com, contact@elnounch.net, parshap+npm@gmail.com, yerko.palma@usach.cl, forbes@lindesay.co.uk, martin.heidegger@gmail.com, garann@gmail.com, bcomnes@gmail.com, vestibule@anandthakker.net, dave.des@gmail.com, hughskennedy@gmail.com, pereira.filype@gmail.com, renee@kooi.me, post.ben.here@gmail.com, github@tixz.dk, maochenyan@gmail.com, peteris.krumins@gmail.com, me@JoshDuff.com, shtylman@gmail.com, lukechilds123@gmail.com, raynos2@gmail.com, 
socket.io: rauchg@gmail.com, damien.arrachequesne@gmail.com, 
ts-node: hello@blakeembrey.com, cspotcode@gmail.com, 
mocha-lcov-reporter: steven.looman@gmail.com, 
superagent: shtylman@gmail.com, npmspam@geekhood.net, naman34@gmail.com, niftylettuce@gmail.com, nw@nwhite.net, rauchg@gmail.com, andrew@ziglang.org, npm@titanism.com, tj@vision-media.ca, tj@travisjeffery.com, 
nodemon: remy@leftlogic.com, 
js-yaml: vitaly@rcdesign.ru, 
handlebars: kpdecker@gmail.com, wycats@gmail.com, lawnsea@gmail.com, github.erisds@gmail.com, npm@knappi.org, 
yosay: ruyadorno@hotmail.com, marceloshima@gmail.com, ulisesgascondev@gmail.com, sindresorhus@gmail.com, admin@simonboudrias.com, eddie+npm@eddiemonge.com, addyosmani@gmail.com, mail@michael-kuehnel.de, mehdy.dara.fr@gmail.com, 
babel-plugin-transform-decorators-legacy: ide+npm@jameside.com, loganfsmyth@gmail.com, 
broccoli-asset-rev: npm@nathanhammond.com, r@rickharrison.me, me@rwjblue.com, stefan.penner@gmail.com, tobias.bieniek@gmx.de, 
ejs: mde@fleegix.org, 
tap: i@izs.me, 
ember-cli-inject-live-reload: me@rwjblue.com, tobias.bieniek@gmail.com, stefan.penner@gmail.com, 
eslint-plugin-babel: daniel@tschinder.de, bng412@gmail.com, hi@henryzoo.com, npm@jameshenry.email, kai@kaicataldo.com, loganfsmyth@gmail.com, monastic.panic@gmail.com, public@mysticatea.dev, nicolo.ribaudo@gmail.com, teddy.katz@gmail.com, npm@sebastian.barretomckenzie.com, zertosh@gmail.com, 
jade: forbes@lindesay.co.uk, 
tap-spec: scottcorgan@gmail.com, 
husky: typicode@gmail.com, 
ember-cli-qunit: stefan.penner+ember-cli@gmail.com, npm@nathanhammond.com, me@rwjblue.com, stefan.penner@gmail.com, trentmwillis@gmail.com, tobias.bieniek@gmx.de, 
jscs: hi@henryzoo.com, markelog@gmail.com, mdevils@yandex.ru, mike.sherov@gmail.com, joel@mrjoelkemp.com, zxqfox@gmail.com, 
redis: gkorland@gmail.com, leibale1998@gmail.com, mjr@ranney.com, 
ember-cli-uglify: jesper.karsrud@gmail.com, me@rwjblue.com, stefan.penner@gmail.com, tobias.bieniek@gmx.de, 
ember-cli-dependency-checker: emreunal99@gmail.com, me@rwjblue.com, tobias.bieniek@gmail.com, stefan.penner@gmail.com, 
ember-export-application-global: me@rwjblue.com, stefan.penner@gmail.com, 
marked: chjjeffrey@gmail.com, steven@ceriously.com, josh@8fold.pro, tony@brix.ninja, 
path: coolaj86@gmail.com, jindersidhu@gmail.com, shtylman@gmail.com, 
webpack-dev-middleware: tobias.koppers@googlemail.com, mail@johannesewald.de, sheo13666q@gmail.com, hello@hiroppy.me, 
gulp-load-plugins: jack@jackfranklin.net, hello@jameelmoses.com, 
browser-sync: shakyshane@gmail.com, 
jsdoc: jeffrey.l.williams@gmail.com, 
rollup-plugin-babel: i@jhuang.me, nicolo.ribaudo@gmail.com, hi@henryzoo.com, loganfsmyth@gmail.com, daniel@tschinder.de, bng412@gmail.com, mateuszburzynski@gmail.com, brian@donovans.cc, richard.a.harris@gmail.com, victorystick@gmail.com, trysound@yandex.ru, jason@developit.ca, andrew@shellscape.org, 
npm-run-all: star.ctor@gmail.com, 
ember-cli-babel: kellyselden@gmail.com, me@rwjblue.com, stefan.penner@gmail.com, tobias.bieniek@gmail.com, stefan.penner+ember-cli@gmail.com, 
ember-cli-htmlbars: jonathan.jackson1@me.com, edward@eaf4.com, me@rwjblue.com, katie@kmg.io, tobias.bieniek@gmail.com, stefan.penner@gmail.com, stefan.penner+ember-cli@gmail.com, 
webpack-hot-middleware: glenjamin@gmail.com, wiens.joshua@gmail.com, 
cz-conventional-changelog: kent+commitizen-bot@doddsfamily.us, jimthedev@gmail.com, kent@doddsfamily.us, linus@folkdatorn.se, info@pietrobongiovanni.com, 
extend: justmoon@members.fsf.org, ljharb@gmail.com, 
bootstrap: getbootstrap@gmail.com, markdotto@gmail.com, xhmikosr@gmail.com, 
vue: yyx990803@gmail.com, posva13@gmail.com, 
karma-mocha-reporter: info@litixsoft.de, 
rollup: brian@donovans.cc, trysound@yandex.ru, richard.a.harris@gmail.com, victorystick@gmail.com, lukas.taegert@tngtech.com, 
semantic-release: npm@travi.org, pierre.denis.vanduynslager@gmail.com, semantic-release@martynus.net, gregor@martynus.net, 
flow-bin: marshall@roch.com, gabelevi@gmail.com, gkzahariev@gmail.com, nat@natmote.net, flow@fb.com, samwgoldman@gmail.com, avik.ch@gmail.com, pvekris@fb.com, jmbrown@fb.com, sainati@fb.com, mmvitousek@gmail.com, 
ember-cli-app-version: me@rwjblue.com, tarasm@gmail.com, stefan.penner@gmail.com, alex@lafroscia.com, 
typings: hello@blakeembrey.com, 
rollup-plugin-node-resolve: npm@keithcirkel.co.uk, lukas.taegert@tngtech.com, richard.a.harris@gmail.com, andrew@shellscape.org, trysound@yandex.ru, 
morgan: doug@somethingdoug.com, 
react-redux: dan.abramov@gmail.com, timdorr@timdorr.com, mark.erikson@gmail.com, 
ember-disable-prototype-extensions: me@rwjblue.com, stefan.penner@gmail.com, tobias.bieniek@gmx.de, 
xml2js: marek@xivilization.net, 
gulp-autoprefixer: sindresorhus@gmail.com, 
mongodb: mbroadst@gmail.com, durran@gmail.com, bailey.pearson@gmail.com, neal.beeken@mongodb.com, kaitlin.mahar@mongodb.com, daria.pardue@mongodb.com, 
webpack-merge: bebraw@gmail.com, 
react-router: timdorr@timdorr.com, npm@mjackson.me, hi@chance.dev, 
nodeunit: caolan@caolanmcmahon.com, reinstein.mike@gmail.com, 
nock: npm@zephyr.to, i@pgte.me, gregor@martynus.net, nockbot@martynus.net, 
postcss: andrey@sitnik.ru, 
cookie-parser: doug@somethingdoug.com, shtylman@gmail.com, 
promise: forbes@lindesay.co.uk, nathan@nathan7.eu, 
proxyquire: bvdrucker@gmail.com, thlorenz@gmx.de, 
webpack: tobias.koppers@googlemail.com, mail@johannesewald.de, 
react-hot-loader: dan.abramov@gmail.com, montogeek@gmail.com, berge.greg@gmail.com, thekashey@gmail.com, newman.cale@gmail.com, wojtek.kwiatek@gmail.com, 
reflect-metadata: rbuckton@chronicles.org, 
less-loader: sheo13666q@gmail.com, tobias.koppers@googlemail.com, mail@johannesewald.de, 
isparta: douglasduteil@gmail.com, 
ember-cli-htmlbars-inline-precompile: stefan.penner+ember-cli@gmail.com, me@rwjblue.com, stefan.penner@gmail.com, tobias.bieniek@gmail.com, 
raw-loader: sheo13666q@gmail.com, tobias.koppers@googlemail.com, mail@johannesewald.de, michael.ciniawsky@gmail.com, wiens.joshua@gmail.com, eric@smarterspam.com, sean.larkin@cuw.edu, 
mongoose: aaron.heckmann+github@gmail.com, rauchg@gmail.com, tj@vision-media.ca, val@karpov.io, 
axios: mzabriskie@gmail.com, nick.uraltsev@gmail.com, emilyemorehouse@gmail.com, jasonsaayman@gmail.com, 
immutable: lee@leebyron.com, 
dotenv: jacoblowe2.0@gmail.com, scott@scottmotte.com, mot@mot.la, 
ws: einaros@gmail.com, npm@3rd-Eden.com, luigipinca@gmail.com, npmjs@3rd-Eden.com, 
gulp-typescript: ivogabe@ivogabe.nl, 
mime: robert@broofa.com, 
eslint-plugin-flowtype: gajus@gajus.com, 
ember-cli-release: me@rwjblue.com, stevenjohnlindberg@gmail.com, 
grunt-contrib-connect: cowboy@rj3.net, jellyes2@gmail.com, kyle@dontkry.com, sindresorhus@gmail.com, tyler@sleekcode.net, vlad@vladikoff.com, 
event-stream: npm@npmjs.com, 
gulp-watch: floatdrop@gmail.com, ultcombo@gmail.com, 
source-map-support: linus@folkdatorn.se, evan.exe@gmail.com, julien.fontanet@isonoe.net, 
bower: sheerun@sher.pl, andremiguelcruz@msn.com, 
underscore.string: esa-matti@suuronen.org, pavel@pravosud.com, edtsech@gmail.com, schtoeffel@gmail.com, 
karma-spec-reporter: mich.lex@gmail.com, hdavidzhu@gmail.com, mcgeehonstg@gmail.com, 
ramda: scott@sauyet.com, dc@davidchambers.me, raine.virta@gmail.com, m_hur@yahoo.com, schristopher@konputa.com, aromano@preemptsecurity.com, kwallace@gmail.com, notpmoc84@hotmail.com, 
codecov: jwbecher@drazisil.com, eddie.moore@gmail.com, gabriel@codecov.io, eli@codecov.io, thomasrockhu@gmail.com, 
vinyl-buffer: blaine.bublitz@gmail.com, hughskennedy@gmail.com, 
connect: doug@somethingdoug.com, 
ember-cli-sri: jonathan@jooped.co.uk, me@rwjblue.com, stefan.penner@gmail.com, 
karma-chai: xdissent@me.com, alex.gorbatchev@gmail.com, 
grunt-contrib-coffee: cowboy@rj3.net, jellyes2@gmail.com, kyle@dontkry.com, sindresorhus@gmail.com, tyler@sleekcode.net, vlad@vladikoff.com, 
request-promise: nicolai.kamenzky@testrails.org, mikeal.rogers@gmail.com, jnylen@gmail.com, request@outofindex.com, simeonvelichkov@gmail.com, ty.abonil@gmail.com, 
time-grunt: sindresorhus@gmail.com, 
gulp-replace: lazdnet@gmail.com, 
chokidar: elan.shanker+npm@gmail.com, paul@paulmillr.com, 
through: nopersonsmodules@gmail.com, 
mysql: felix@debuggable.com, sidorares@yandex.com, doug@somethingdoug.com, 
minimatch: i@izs.me, 
html-loader: sheo13666q@gmail.com, tobias.koppers@googlemail.com, mail@johannesewald.de, 
concat-stream: alan138@gmail.com, mathiasbuus@gmail.com, max@maxogden.com, 
rollup-plugin-commonjs: lukas.taegert@tngtech.com, richard.a.harris@gmail.com, andrew@shellscape.org, trysound@yandex.ru, victorystick@gmail.com, 
codelyzer: mgechev@gmail.com, 
ora: sindresorhus@gmail.com, 
koa: haoxinst@gmail.com, niftylettuce@gmail.com, dead_horse@qq.com, tj@vision-media.ca, jonathanrichardong@gmail.com, fengmk2@gmail.com, npm@titanism.com, 
gulp-if: robrich@robrich.org, 
opn: sindresorhus@gmail.com, 
prompt: fedor.indutny@gmail.com, jcrugzz@gmail.com, charlie.robbins@gmail.com, bradley.meck@gmail.com, cyril.auburtin@gmail.com, 
ember-resolver: matt.beale@madhatted.com, me@rwjblue.com, tobias.bieniek@gmail.com, stefan.penner@gmail.com, 
eslint-plugin-node: star.ctor@gmail.com, 
http-server: charlie.robbins@gmail.com, byoung@bigbluehat.com, jade@jmthornton.net, 
protractor: devops+npm@angular.io, node-team-npm+wombot@google.com, 
cross-spawn: andremiguelcruz@msn.com, 
gulp-header: tracker1@gmail.com, ericbombhax@gmail.com, 
gulp-clean: peter.vilja@gmail.com, 
grunt-release: dorgan@donaldorgan.com, info@drublic.de, davidcgeddes@gmail.com, 
open: sindresorhus@gmail.com, 
xtend: raynos2@gmail.com, 
commitizen: linus@folkdatorn.se, me@kentcdodds.com, jimthedev@gmail.com, jimthedev+commitizen-bot@gmail.com, info@pietrobongiovanni.com, 
vue-loader: yyx990803@gmail.com, haoqunjiang+npm@gmail.com, 
assert: calvin.metcalf@gmail.com, lukechilds123@gmail.com, substack@gmail.com, renee@kooi.me, ljharb@gmail.com, coolaj86@gmail.com, shtylman@gmail.com, 
require-dir: aseem.kishore@gmail.com, ericbombhax@gmail.com, 
karma-cli: dignifiedquire@gmail.com, vojta.jina+npm@gmail.com, mark@zzo.com, 
loader.js: stefan.penner+ember-cli@gmail.com, kratiahuja@gmail.com, kris.selden@gmail.com, im.mmun@gmail.com, me@rwjblue.com, stefan.penner@gmail.com, 
vows: self@cloudhead.net, evan@e14n.com, charlie.robbins@gmail.com, code@legitimatesounding.com, me@mmalecki.com, alex@strugee.net, 
stylus: panyakor@gmail.com, kizmarh@ya.ru, chupurnov@gmail.com, tj@vision-media.ca, chenleicoder@gmail.com, 
grunt-browserify: jmreidy@gmail.com, tommy.leunen@gmail.com, cnspeckn@googlemail.com, 
copy-webpack-plugin: sheo13666q@gmail.com, tobias.koppers@googlemail.com, mail@johannesewald.de, 
karma-browserify: bvdrucker@gmail.com, git_nikku@nixis.de, xdissent@me.com, alex.gorbatchev@gmail.com, 
meow: sindresorhus@gmail.com, 
socket.io-client: rauchg@gmail.com, damien.arrachequesne@gmail.com, 
ts-loader: hello@blakeembrey.com, james@jbrantly.com, johnny_reilly@hotmail.com, 
gulp-bump: me@slacy.me, 
ember-try: kellyselden@gmail.com, me@rwjblue.com, katie@kmg.io, stefan.penner@gmail.com, ember-try@kmg.io, 
grunt-karma: davidcgeddes@gmail.com, dignifiedquire@gmail.com, mark@zzo.com, vojta.jina+npm@gmail.com, karmarunnerbot@gmail.com, 
gulp-less: me@slacy.me, chris@chriscowan.us, ericbombhax@gmail.com, 
ember-ajax: kellyselden@gmail.com, tarasm@gmail.com, tobias.bieniek@gmail.com, alex@lafroscia.com, 
ember-cli-ic-ajax: me@rwjblue.com, stefan.penner@gmail.com, 
gh-pages: mark.john.dalgleish@gmail.com, tim.schaub@gmail.com, 
loader-utils: sheo13666q@gmail.com, tobias.koppers@googlemail.com, mail@johannesewald.de, 
whatwg-fetch: me@jakechampion.name, matt@mattandre.ws, mislav.marohnic@gmail.com, 
joi: eran@hammer.io, 
grunt-bump: eddie+npm@eddiemonge.com, dev@wunschik.net, vojta.jina+npm@gmail.com, 
ember-cli-content-security-policy: me@rwjblue.com, npm@jhanschke.de, 
ember-load-initializers: npm@nathanhammond.com, kellyselden@gmail.com, me@rwjblue.com, chadhietala@gmail.com, katie@kmg.io, tobias.bieniek@gmail.com, stefan.penner@gmail.com, trabus@gmail.com, stefan.penner+ember-cli@gmail.com, 
connect-history-api-fallback: bripkens.dev@gmail.com, 
concurrently: kimmo.brunfeldt+public@gmail.com, guhenke@gmail.com, 
grunt-contrib-cssmin: cowboy@rj3.net, joern.zaefferer@gmail.com, james_account@icloud.com, tyler@sleekcode.net, vlad@vladikoff.com, kyle@dontkry.com, sindresorhus@gmail.com, xhmikosr@gmail.com, 
compression: doug@somethingdoug.com, 
grunt-shell: sindresorhus@gmail.com, 
jasmine-spec-reporter: bastien.caudan@gmail.com, 
express-session: doug@somethingdoug.com, 
benchmark: john@fusejs.com, mathias@qiwi.be, 
isomorphic-fetch: matt@mattandre.ws, strategic.products+npm@ft.com, 
node-fetch: jimmy@warting.se, bitinn@gmail.com, timothygu99@gmail.com, npm@kepinski.ch, jimmy+node-fetch@warting.se, 
vue-style-loader: yyx990803@gmail.com, haoqunjiang+npm@gmail.com, 
rollup-plugin-uglify: trysound@yandex.ru, 
qs: quitlahok@gmail.com, ljharb@gmail.com, 
matchdep: blaine@iceddev.com, tyler@sleekcode.net, 
watch: me@levithomason.com, derfinn@gmail.com, mikeal.rogers@gmail.com, 
gulp-notify: mikaelbre@gmail.com, 
gulp-coffee: contact@wearefractal.com, ericbombhax@gmail.com, 
gulp-nsp: ops@andyet.net, quitlahok@gmail.com, baldwin@andyet.net, joeycozza@gmail.com, 
gulp-exclude-gitignore: admin@simonboudrias.com, matija.marohnic@gmail.com, contact@arthurverschaeve.be, sindresorhus@gmail.com, addyosmani@gmail.com, 
ncp: charlie@charlieistheman.com, me@mmalecki.com, 
gulp-coveralls: mark.john.dalgleish@gmail.com, 
ghooks: guilherme.tramontina@gmail.com, jhabdas@gmail.com, 
yeoman-assert: ruyadorno@hotmail.com, marceloshima@gmail.com, ulisesgascondev@gmail.com, sindresorhus@gmail.com, admin@simonboudrias.com, eddie+npm@eddiemonge.com, addyosmani@gmail.com, mail@michael-kuehnel.de, mehdy.dara.fr@gmail.com, github@stefanbuck.com, 
codeclimate-test-reporter: noahd1@yahoo.com, davehenton@gmail.com, will+npm@flemi.ng, jimmy@codeclimate.com, 
redux-thunk: dan.abramov@gmail.com, timdorr@timdorr.com, mark.erikson@gmail.com, 
http-proxy-middleware: stevenchim@gmail.com, 
serve-static: doug@somethingdoug.com, 
highlight.js: marcos@marcosc.com, me@joshgoebel.com, maniac@softwaremaniacs.org, highlightjs.automation@gmail.com, 
rewire: mail@johannesewald.de, developers@peerigon.com, 
tmp: npm@spam.raszi.hu, 
hapi: eran@hueniverse.com, 
ember-data: runspired+ember-data@gmail.com, runspired@gmail.com, npm@hjdivad.com, me@rwjblue.com, stefan.penner@gmail.com, bmac325@gmail.com, dstanley.stuart@gmail.com, dan@cerebris.com, terzicigor@gmail.com, kellyselden@gmail.com, dcyriller@gmail.com, heroiceric@gmail.com, snewcomer24@gmail.com, 
ember-disable-proxy-controllers: miguel.camba@gmail.com, 
lab: eran@hammer.io, 
gulp-filter: sindresorhus@gmail.com, 
babel-preset-es2015-rollup: me@brian-donovan.com, richard.a.harris@gmail.com, 
systemjs: joeldenning@gmail.com, guybedford@gmail.com, 
passport: jaredhanson@gmail.com, 
pg: brian.m.carlson@gmail.com, 
temp: brwcodes@gmail.com, rocketteerapps@gmail.com, 
eslint-plugin-html: bzugmeyer@gmail.com, 
esprima: ariya.hidayat@gmail.com, 
karma-sinon-chai: brunner.adam@gmail.com, kev.mees@gmail.com, 
bunyan: trentm@gmail.com, 
inherits: i@izs.me, 
serve-favicon: doug@somethingdoug.com, 
d3: mike@ocks.org, fil@rezo.net, 
awesome-typescript-loader: fnight.m@gmail.com, 
gulp-jscs: sindresorhus@gmail.com, 
es6-shim: paul@paulmillr.com, ljharb@gmail.com, 
grunt-eslint: sindresorhus@gmail.com, 
cors: doug@somethingdoug.com, troygoode@gmail.com, 
gulp-shell: sun.zheng.an.0@gmail.com, 
yeoman-test: admin@simonboudrias.com, marceloshima@gmail.com, ruyadorno@hotmail.com, eddie+npm@eddiemonge.com, mail@michael-kuehnel.de, contact@arthurverschaeve.be, 
power-assert: takuto.wada@gmail.com, 
eslint-config-xo-space: sindresorhus@gmail.com, hello@mario-nebl.de, 
jsonwebtoken: damian.schenkelman@gmail.com, sebastian.iacomuzzi@gmail.com, jaredhanson@gmail.com, jfromaniello@gmail.com, j@jasonstrutz.com, balmacedaluciano@gmail.com, matiasw@gmail.com, eduardo.diaz@auth0.com, 
nsp: quitlahok@gmail.com, baldwin@andyet.net, 
code: eran@hammer.io, 
vinyl: ericbombhax@gmail.com, blaine.bublitz@gmail.com, 
graceful-fs: i@izs.me, 
mustache: jan@apache.org, dasilvacontin@gmail.com, johphi@gmail.com, 
update-notifier: sindresorhus@gmail.com, admin@simonboudrias.com, eddie+npm@eddiemonge.com, addyosmani@gmail.com, mail@michael-kuehnel.de, mehdy.dara.fr@gmail.com, ulisesgascondev@gmail.com, marceloshima@gmail.com, ruyadorno@hotmail.com, 
node-emoji: daniel@touchlay.com, nicolas.charpentier079@gmail.com, 
clone: paul@vorb.de, 
faucet: mail@substack.net, 
grunt-jscs: gustavo@injoin.io, markelog@gmail.com, 
eventsource-polyfill: devel@amvtek.com, 
blanket: hi@alexanderseville.com, 
source-map-loader: sheo13666q@gmail.com, tobias.koppers@googlemail.com, mail@johannesewald.de, 
validator: cohara87@gmail.com, prof@nandaa.com, 
istanbul-instrumenter-loader: kir@belevi.ch, wiens.joshua@gmail.com, 
sqlite3: dane@mapbox.com, mail@kkaefer.com, tom@macwright.com, github.erisds@gmail.com, young@mapbox.com, sam@mapbox.com, mully@mapbox.com, kewde@particl.io, hi@daniellockyer.com, 
eslint-plugin-mocha: npm@lxanders.com, jfm.engels@gmail.com, schreck.mathias@gmail.com, 
progress: scalesjordan@gmail.com, rhyneandrew@gmail.com, me@thejameskyle.com, tj@vision-media.ca, 
karma-safari-launcher: max.deyatov@gmail.com, vojta.jina+npm@gmail.com, mark@zzo.com, dignifiedquire@gmail.com, 
normalize.css: nicolasgallagher@gmail.com, 
resolve: ljharb@gmail.com, substack@gmail.com, 
history: npm@mjackson.me, 
backbone: jashkenas@gmail.com, dunbarb2@gmail.com, justin+npm@ridgewell.name, dev@juliangonggrijp.com, 
gulp-connect: dev@vld.me, justin.m.chase@gmail.com, 
when: info@cujojs.com, 
babel-plugin-react-transform: me@thejameskyle.com, dan.abramov@gmail.com, 
eslint-friendly-formatter: royriojas@gmail.com, 
iconv-lite: ashtuchkin@gmail.com, 
md5: coolaj86@gmail.com, paul@vorba.ch, 
imports-loader: sheo13666q@gmail.com, tobias.koppers@googlemail.com, mail@johannesewald.de, 
codecov.io: steve@codecov.io, gregg@caines.ca, 
nodemailer: andris@kreata.ee, 
merge-stream: glurgle@gmail.com, snnskwtnb@gmail.com, maochenyan@gmail.com, 
cli-table: rauchg@gmail.com, batmoo@gmail.com, sarosh.aga@automattic.com, 
merge: yeikos@gmail.com, 
brfs: substack@gmail.com, feross@feross.org, me@gkatsev.com, zertosh@gmail.com, mathiasbuus@gmail.com, max@maxogden.com, thlorenz10@gmail.com, terinjokes@gmail.com, npm-public@jessemccarthy.net, palmermebane@gmail.com, darawk@gmail.com, b@lupton.cc, calvin.metcalf@gmail.com, jprichardson@gmail.com, fedor@indutny.com, jryans@gmail.com, sethvincent@gmail.com, yoshuawuyts@gmail.com, ungoldman@gmail.com, michael.williams@enspiral.com, contact@elnounch.net, parshap+npm@gmail.com, yerko.palma@usach.cl, forbes@lindesay.co.uk, martin.heidegger@gmail.com, garann@gmail.com, bcomnes@gmail.com, vestibule@anandthakker.net, dave.des@gmail.com, hughskennedy@gmail.com, pereira.filype@gmail.com, renee@kooi.me, post.ben.here@gmail.com, github@tixz.dk, maochenyan@gmail.com, peteris.krumins@gmail.com, me@JoshDuff.com, shtylman@gmail.com, lukechilds123@gmail.com, raynos2@gmail.com, 
cli-color: medikoo+npm@medikoo.com, 
jsdoc-to-markdown: 75pound@gmail.com, 
grunt-contrib-less: cowboy@rj3.net, james_account@icloud.com, tyler@sleekcode.net, vlad@vladikoff.com, kyle@dontkry.com, sindresorhus@gmail.com, xhmikosr@gmail.com, 
jsonfile: jprichardson@gmail.com, opensrc@ryanzim.com, 
http-proxy: aristizabal.daniel@gmail.com, charlie.robbins@gmail.com, jcrugzz@gmail.com, yawn.localhost@gmail.com, 
clean-css: contact@jakubpawlowicz.com, jakub@goalsmashers.com, 
lint-staged: andrey@okonet.ru, 
merge2: admin@zensh.com, 
gulp-livereload: demurgos@demurgos.net, david@jcyr.us, 
source-map: tigleym@gmail.com, niklasbaumgardner@gmail.com, eemeli@gmail.com, npm-owners@mozilla.com, mythmon@gmail.com, jkratzer@mozilla.com, factorui.npm@mozilla.com, project-nimbus-publishing@mozilla.com, gijskruitbosch@gmail.com, chevobbe.nicolas@gmail.com, brizental@mozilla.com, aplacitelli@mozilla.com, rhelmer@mozilla.com, ted@knowtheory.net, brizental+moz-glean@mozilla.com, nfitzgerald@mozilla.com, fitzgen@gmail.com, loganfsmyth@gmail.com, ejpbruel@gmail.com, tom@tromey.com, 
js-beautify: daniel.stockman@gmail.com, bitwiseman@gmail.com, 
webpack-stream: kyle@dontkry.com, 
babel-preset-es2015-loose: brandon@konkle.us, 
invariant: zertosh@gmail.com, christoph.pojer@gmail.com, yungsters@gmail.com, 
postcss-import: andrey@sitnik.ru, opensrc@ryanzim.com, 
grunt-simple-mocha: yaymukund@gmail.com, 
gulp-git: me@slacy.me, 
mockery: npm@npmjs.com, 
ember-cli-jshint: alexandre.baizeau@gmail.com, stefan.penner+ember-cli@gmail.com, me@rwjblue.com, stefan.penner@gmail.com, tobias.bieniek@gmx.de, 
karma-sauce-launcher: dignifiedquire@gmail.com, johnjbarton@johnjbarton.com, mark@zzo.com, vojta.jina+npm@gmail.com, karmarunnerbot@gmail.com, 
gulp-postcss: unsoundscapes@gmail.com, 
validate-commit-msg: jonathan@garbee.me, kent@doddsfamily.us, nick@balestra.ch, 
clean-webpack-plugin: johnagan@gmail.com, 
config: mark@rideamigos.com, npm@lorenwest.com, 
gulp-tslint: panu.horsmalahti@iki.fi, 
wrench: ryan@venodesigns.net, 
pug: forbes@lindesay.co.uk, pug-bot@rollingversions.com, 
node-libs-browser: mail@johannesewald.de, tobias.koppers@googlemail.com, sean.larkin@cuw.edu, 
gulp-line-ending-corrector: ishafayet@gmail.com, 
ember-cli-test-loader: npm@hjdivad.com, katie@kmg.io, kellyselden@gmail.com, npm@nathanhammond.com, me@rwjblue.com, stefan.penner@gmail.com, tobias.bieniek@gmail.com, 
karma-babel-preprocessor: mattias.buelens@gmail.com, shuhei.kagawa@gmail.com, hi@henryzoo.com, 
log4js: gareth.nomiddlename@gmail.com, 
querystring: dev@gozala.io, medikoo+npm@medikoo.com, 
nconf: jcrugzz@gmail.com, charlie.robbins@gmail.com, matthew.hamann@gmail.com, 
deep-equal: substack@gmail.com, ljharb@gmail.com, 
standard-version: maochenyan@gmail.com, bencoe@gmail.com, moilanen.tapani@gmail.com, tommywo@o2.pl, andrewbgoode@gmail.com, bencoe+oss-bot@gmail.com, 
gulp-clean-css: salvatore.niro@outlook.com, 
gulp-imagemin: sindresorhus@gmail.com, 
coffeelint: clutchski@gmail.com, 
browserify-shim: bvdrucker@gmail.com, thlorenz@gmx.de, 
path-to-regexp: hello@blakeembrey.com, doug@somethingdoug.com, jonathanrichardong@gmail.com, jonathanrichardong@gmail.com, shtylman@gmail.com, 
snazzy: john@hiesey.com, bcomnes@gmail.com, feross@feross.org, flettre@gmail.com, linus@folkdatorn.se, mathiasbuus@gmail.com, jprichardson@gmail.com, w@tson.dk, raynos2@gmail.com, toddbluhm@gmail.com, pelle@kodfabrik.se, 
gulp-size: sindresorhus@gmail.com, 
gulp-browserify: hop2deep@gmail.com, 
gulp-changed: sindresorhus@gmail.com, 
koa-router: niftylettuce@gmail.com, npm@titanism.com, 
webpack-node-externals: liadydev@gmail.com, 
stylelint: stephen@netweb.com.au, david.dave.clark@gmail.com, npm@richardhallows.com, npm@moox.io, aleks@hudochenkov.com, jathak@gmail.com, 
globby: sindresorhus@gmail.com, 
pify: sindresorhus@gmail.com, 
bindings: nathan@tootallnate.net, 
which: fritzy@github.com, i@izs.me, darcy@darcyclarke.me, ruyadorno@hotmail.com, quitlahok@gmail.com, gar+npm@danger.computer, luke@lukekarrys.com, 
execa: sindresorhus@gmail.com, ehmicky@gmail.com, 
typedoc: hello@blakeembrey.com, s.lenz@gmail.com, a3chic9@gmail.com, gerrit@gerritbirkeland.com, typedoc@gerritbirkeland.com, 
grunt-babel: daniel@tschinder.de, hi@henryzoo.com, loganfsmyth@gmail.com, sebmck@gmail.com, sindresorhus@gmail.com, 
url: coolaj86@gmail.com, ljharb@gmail.com, shtylman@gmail.com, 
lru-cache: i@izs.me, 
archiver: chris@talkingtontech.com, 
vue-router: yyx990803@gmail.com, posva13@gmail.com, 
got: sindresorhus@gmail.com, sz.marczak@gmail.com, 
grunt-jsdoc: chevrier.bertrand@gmail.com, 
escodegen: utatane.tea@gmail.com, npm@michael.ficarra.me, 
nopt: fritzy@github.com, darcy@darcyclarke.me, ruyadorno@hotmail.com, quitlahok@gmail.com, gar+npm@danger.computer, luke@lukekarrys.com, 
strip-ansi: sindresorhus@gmail.com, josh@junon.me, 
eslint-config-google: addyosmani@gmail.com, philip@philipwalton.com, sindresorhus@gmail.com, 
karma-ie-launcher: vojta.jina+npm@gmail.com, mark@zzo.com, dignifiedquire@gmail.com, 
esdoc: h13i32maru@gmail.com, 
multer: captain@hacksparrow.com, linus@folkdatorn.se, japes@aberlorn.com, 
boom: eran@hammer.io, 
grunt-contrib-qunit: cowboy@rj3.net, joern.zaefferer@gmail.com, roaster.karmic_0r@icloud.com, krinklemail@gmail.com, tyler@sleekcode.net, leonardo.balter@gmail.com, vlad@vladikoff.com, kyle@dontkry.com, sindresorhus@gmail.com, jsoverson@gmail.com, brahim.arkni@gmail.com, 
es5-shim: dev@gozala.io, kris.kowal@cixar.com, ljharb@gmail.com, 
vue-html-loader: yyx990803@gmail.com, 
zuul: shtylman@gmail.com, feross@feross.org, vincent.voyer@gmail.com, 
lolex: christian@cjohansen.no, carlerik@gmail.com, mail@maxantoni.de, morgan@roderick.dk, 
deepmerge: me@JoshDuff.com, 
gulp-jasmine: jbblanchet@gmail.com, sindresorhus@gmail.com, 
ts-helpers: hochelmartin@gmail.com, info@ngparty.cz, 
postcss-cssnext: jonathantneal@hotmail.com, npm@moox.io, semigradskyd@gmail.com, 
isparta-loader: kir@soulshine.in, 
function-bind: raynos2@gmail.com, ljharb@gmail.com, 
shortid: dylang@gmail.com, andrey@sitnik.ru, 
events: dev@gozala.io, renee@kooi.me, shtylman@gmail.com, 
hoek: eran@hammer.io, 
vinyl-fs: ericbombhax@gmail.com, blaine.bublitz@gmail.com, 
karma-jasmine-html-reporter: david.federman@outlook.com, 
recursive-readdir: jergason@gmail.com, hello@bnb.im, 
moment-timezone: iskren.chernev@gmail.com, washwithcare@gmail.com, mj1856@hotmail.com, maggiepint@gmail.com, marwahaha@berkeley.edu, elenasharovar@gmail.com, 
xmldom: jinyun.jin@gmail.com, jindw@xidea.org, 
rsvp: stanley@stan.li, matt.beale@madhatted.com, me@rwjblue.com, rpflorence@gmail.com, stefan.penner@gmail.com, wycats@gmail.com, 
envify: tim@timwis.com, i@yoshuawuyts.com, hughskennedy@gmail.com, zertosh@gmail.com, 
gulp-debug: sindresorhus@gmail.com, 
github: gregor@martynus.net, joe@brassafrax.com, info@mikedeboer.nl, octokitbot@martynus.net, zeke@sikelianos.com, 
hubot: blavender+npm@gmail.com, brandon@opensoul.org, josh+hubotbot@technicalpickles.com, npm@anselcomputers.com, josh@technicalpickles.com, 
babel-istanbul: jeff.mcriffey@tryambition.com, 
qunitjs: richard.gibson@gmail.com, joern.zaefferer@gmail.com, leonardo.balter@gmail.com, trentmwillis@gmail.com, 
karma-sinon: januszjablonski.pl+npm@gmail.com, 
atom-space-pen-views: atom@github.com, lee@lee-dohm.com, nathan@github.com, ogle.ben@gmail.com, kevinsawicki@gmail.com, maxbrunsfeld@gmail.com, 
exports-loader: sheo13666q@gmail.com, tobias.koppers@googlemail.com, mail@johannesewald.de, 
bcrypt: john.firebaugh@gmail.com, nathan@tootallnate.net, nicholas.j.campbell@gmail.com, shtylman@gmail.com, amitosh.swain@gmail.com, 
util: ljharb@gmail.com, renee@kooi.me, substack@gmail.com, lukechilds123@gmail.com, calvin.metcalf@gmail.com, coolaj86@gmail.com, shtylman@gmail.com, 
markdown-it: vitaly@rcdesign.ru, 
html-minifier: alexlamsl@gmail.com, kangax@gmail.com, mathias@qiwi.be, 
grunt-coffeelint: email@adambig.gs, WittigMarcus@gmail.com, vojta.jina+npm@gmail.com, 
string: jprichardson@gmail.com, az7arul@gmail.com, 
ip: brad@memoryleak.org, charlie.robbins@gmail.com, me@mmalecki.com, fedor@indutny.com, fedor.indutny@gmail.com, 
passport-local: jaredhanson@gmail.com, 
mocha-phantomjs: ken@metaskills.net, nathan@nathanblack.org, 
redux-logger: arbesfeld@gmail.com, 
vue-hot-reload-api: haoqunjiang+npm@gmail.com, yyx990803@gmail.com, 
faker: marak.squires@gmail.com, 
react-tap-event-plugin: daniel@danielvanhoesel.nl, 
co-mocha: hello@blakeembrey.com, 
grunt-exec: graeme.wicksted@gmail.com, jacob.s.harding@gmail.com, 
grunt-contrib-jasmine: cowboy@rj3.net, james_account@icloud.com, tyler@sleekcode.net, vlad@vladikoff.com, kyle@dontkry.com, sindresorhus@gmail.com, jsoverson@gmail.com, 
react-bootstrap: monastic.panic@gmail.com, tesrin@gmail.com, ktsang.work@gmail.com, 
pkginfo: charlie.robbins@gmail.com, 
tslint-loader: bhovhannes@gmail.com, soos.gabor86@gmail.com, wbuchwalter@gmail.com, 
grunt-concurrent: sindresorhus@gmail.com, 
uglifyify: hughskennedy@gmail.com, luwei.here@gmail.com, i@yoshuawuyts.com, 
mz: me@evancarroll.com, haoxins@outlook.com, dropbox@ricostacruz.com, linus@folkdatorn.se, dead_horse@qq.com, dead_horse@qq.com, jonathanrichardong@gmail.com, arpad.borsos@googlemail.com, 
JSONStream: sethkfman@gmail.com, bhdecker84@gmail.com, dan@danfinlay.com, aaron@kumavis.me, rekmarks@protonmail.com, security@metamask.io, markjstacey@gmail.com, brian.woodward@gmail.com, daern91@gmail.com, 
diff: kpdecker@gmail.com, 
restify: npm@blankenship.io, trentm@gmail.com, gui.hermeto@gmail.com, mjr578@gmail.com, oss@mmarchini.me, pmooney@pfmooney.com, email@martonpeter.com, mcavage@gmail.com, yjxiao@gmail.com, jgilli@fastmail.fm, donutespresso@gmail.com, rajatkumartx@gmail.com, danderso@gmail.com, dev@harrington.pizza, 
method-override: fishrock123@rocketmail.com, tj@vision-media.ca, doug@somethingdoug.com, jonathanrichardong@gmail.com, shtylman@gmail.com, 
eventemitter2: paolo@async.ly, rangermauve@hotmail.com, 
in-publish: me@re-becca.org, 
nunjucks: longster@gmail.com, alexander.inozemtsev@gmail.com, samypesse@gmail.com, carl@oddbird.net, fdintino@gmail.com, 
split: nopersonsmodules@gmail.com, 
grunt-mocha-cli: rowno@webspirited.com, 
swig: paul@paularmstrongdesigns.com, 
path-exists: sindresorhus@gmail.com, 
pluralize: me@blakeembrey.com, 
jsx-loader: floydophone@gmail.com, 
grunt-contrib-compress: cowboy@rj3.net, james_account@icloud.com, tyler@sleekcode.net, vlad@vladikoff.com, kyle@dontkry.com, sindresorhus@gmail.com, xhmikosr@gmail.com, 
gulp-template: sindresorhus@gmail.com, 
gulp-insert: ryan@slingingcode.com, nfroidure@elitwork.com, 
fs-promise: kevin@simplectic.com, 
graphql: lee@leebyron.com, ivan.goncharov.ua@gmail.com, greg@hurrell.net, joesavona@fb.com, jkassens@fb.com, asiandrummer@gmail.com, mahoney.mattj@gmail.com, 
semistandard: john@hiesey.com, bcomnes@gmail.com, feross@feross.org, flettre@gmail.com, linus@folkdatorn.se, mathiasbuus@gmail.com, jprichardson@gmail.com, w@tson.dk, raynos2@gmail.com, toddbluhm@gmail.com, pelle@kodfabrik.se, 
stylus-loader: sheo13666q@gmail.com, tobias.koppers@googlemail.com, mail@johannesewald.de, kyle@dontkry.com, mzgoddard@gmail.com, 
optimize-css-assets-webpack-plugin: nunomr@gmail.com, 
lite-server: john@johnpapa.net, 
once: i@izs.me, 
form-data: mikeal.rogers@gmail.com, niftylettuce@gmail.com, iam@alexindigo.com, pierceydylan@gmail.com, npm@titanism.com, 
gm: jonathanrichardong@gmail.com, admin@rwky.net, fragphace@gmail.com, aaron.heckmann+github@gmail.com, 
grunt-jsbeautifier: vishal.4kadam@gmail.com, 
postcss-cli: andrey@sitnik.ru, opensrc@ryanzim.com, 
babel-plugin-lodash: john.david.dalton@gmail.com, mathias@qiwi.be, 
case-sensitive-paths-webpack-plugin: mpratt@protonmail.com, 
acorn: marijnh@gmail.com, mail@adrianheine.de, me@rreverser.com, 
coffeeify: mail@substack.net, its@johan-nordberg.com, 
aws-sdk: george.jing.fu+npm@gmail.com, osa-3p@amazon.com, zheallan@amazon.com, aws-sdk-js-automation@amazon.com, trivikr@amazon.com, 
cookie: doug@somethingdoug.com, 
eventemitter3: npm@3rd-Eden.com, luigipinca@gmail.com, npm@3rd-Eden.com, 
yamljs: contact@jeremyfa.com, 
query-string: sindresorhus@gmail.com, 
react-transform-hmr: me@thejameskyle.com, dan.abramov@gmail.com, 
autoprefixer-loader: phartig@rdrei.net, andrey@sitnik.ru, 
adm-zip: iacob.campia@gmail.com, 
karma-requirejs: vojta.jina+npm@gmail.com, mark@zzo.com, dignifiedquire@gmail.com, 
rollup-plugin-replace: lukas.taegert@tngtech.com, richard.a.harris@gmail.com, andrew@shellscape.org, 
node-static: self@cloudhead.net, charlie.robbins@gmail.com, pablo@pablocantero.com, 
koa-static: aaron.heckmann+github@gmail.com, haoxins@outlook.com, dead_horse@qq.com, eivind.fjeldstad@gmail.com, fengmk2@gmail.com, jonathanrichardong@gmail.com, jonathanrichardong@gmail.com, julian@juliangruber.com, me@tejas.io, tj@vision-media.ca, 
webpack-manifest-plugin: dane.thurber@gmail.com, andrew@shellscape.org, 
rc: arj03@protonmail.ch, cherese.eriepa@outlook.com, gordonhughmartin@gmail.com, andre+npm@staltz.com, pfrazee@gmail.com, whimful@gmail.com, npm.cel@celehner.com, christianbundy@fraction.io, dominic.tarr@gmail.com, 
grunt-contrib-sass: cowboy@rj3.net, jellyes2@gmail.com, kyle@dontkry.com, sindresorhus@gmail.com, tyler@sleekcode.net, vlad@vladikoff.com, 
expose-loader: sheo13666q@gmail.com, tobias.koppers@googlemail.com, mail@johannesewald.de, 
node-notifier: mikaelbre@gmail.com, 
tar: fritzy@github.com, darcy@darcyclarke.me, ruyadorno@hotmail.com, quitlahok@gmail.com, gar+npm@danger.computer, luke@lukekarrys.com, 
htmlparser2: me@feedic.com, 
pump: mathiasbuus@gmail.com, 
reactify: 8mayday@gmail.com, floydophone@gmail.com, 
documentation: agafonkin@gmail.com, john.firebaugh@gmail.com, tom@macwright.com, vestibule@anandthakker.net, 
unique-random-array: sindresorhus@gmail.com, 
ape-tmpl: okunishinishi@gmail.com, 
coz: okunishinishi@gmail.com, 
ape-tasking: okunishinishi@gmail.com, 
filesize: jason.mulligan@avoidwork.com, 
mime-types: doug@somethingdoug.com, jonathanrichardong@gmail.com, 
coffee-coverage: tgumbo@wesleyclover.com, samshitoronto@gmail.com, adem_burak@hotmail.com, vincent.labreche@benbria.com, jeff.tudor@benbria.com, orelbi.gonzalez@benbria.com, npm@lucid.thedreaming.org, 
injectmock: okunishinishi@gmail.com, 
babel-preset-react-native: grabbou@gmail.com, opensource+npm@fb.com, 
gulp-cssnano: beneb.info@gmail.com, 
ape-updating: okunishinishi@gmail.com, 
ape-releasing: okunishinishi@gmail.com, 
budo: yoshuawuyts@gmail.com, dave.des@gmail.com, 
formidable: felix@debuggable.com, npmspam@geekhood.net, cyril.walle@protonmail.com, dev@tunnckocore.anonaddy.com, nathanael.dmc@outlook.fr, 
ember-cli-eslint: bm641024@gmail.com, brsipple42@gmail.com, stefan.penner+ember-cli@gmail.com, jonathan@jooped.co.uk, me@rwjblue.com, tobias.bieniek@gmail.com, 
deep-extend: lotsmanov89@gmail.com, 
chromedriver: giggio@giggio.net, 
remap-istanbul: labs@sitepen.com, 
gulp-format-md: github@sellside.com, 
gulp-ng-annotate: kagami@genshiken.org, 
grunt-conventional-changelog: ben@npmjs.com, maochenyan@gmail.com, 
color: josh@junon.me, 
gulp-nodemon: garietyc@reed.edu, 
install: bn@cs.stanford.edu, 
broccoli-merge-trees: npm@hjdivad.com, joliss42@gmail.com, me@rwjblue.com, stefan.penner@gmail.com, 
crypto-js: evanvosberg@urban.to, 
grunt-newer: tim.schaub@gmail.com, 
ember-welcome-page: rokusu@gmail.com, me@rwjblue.com, katie@kmg.io, stefan.penner@gmail.com, acorncom@gmail.com, 
babylon: hi@henryzoo.com, bng412@gmail.com, nicolo.ribaudo@gmail.com, i@jhuang.me, loganfsmyth@gmail.com, 
gzip-size: sindresorhus@gmail.com, 
docco: jashkenas@gmail.com, 
traverse: mail@substack.net, 
unzip: eoxfeld@gmail.com, joe@fernsroth.com, 
ini: fritzy@github.com, darcy@darcyclarke.me, ruyadorno@hotmail.com, quitlahok@gmail.com, gar+npm@danger.computer, luke@lukekarrys.com, i@izs.me, 
mock-fs: tim.schaub@gmail.com, 
ms: marta.hawkins@gmail.com, hello@kylieis.online, chloectedder@gmail.com, pb.to@icloud.com, daniel.campbell@vercel.com, arian.daneshvar@vercel.com, email@seiya.me, alasdair.monk@gmail.com, sam.selikoff@gmail.com, dl.carter00@gmail.com, me@baruchadi.com, elijah@elijahcobb.com, aaorris@gmail.com, dombusser@gmail.com, ryanto@gmail.com, npm@nathanhammond.com, snokohn@yahoo.com, johnphammail@gmail.com, tknickman@gmail.com, andrew.gadzik@vercel.com, thom@thomcrowe.com, yanick.belanger@yahoo.com, ecklf@icloud.com, amy.burns87@gmail.com, malte.ubl@gmail.com, balazs4web@gmail.com, casey.gowrie@vercel.com, samuel.foster@vercel.com, swarnavasengupta@gmail.com, lydiahallie.dev@gmail.com, ethan@arrowood.dev, kwon.ohjoong@gmail.com, kakadiadarpan@gmail.com, amanmittal.work@gmail.com, endangeredmassa@gmail.com, nick.tracey@vercel.com, wizard@roborooter.com, gal@spitfire.co.il, liam.crowter@vercel.com, greg.soltis@vercel.com, epallerols@vercel.com, me@domysee.com, natewienert@gmail.com, adrian@op74.net, steph.dietz@vercel.com, gudmundur.bjarni@gmail.com, marc@marcgreenstock.com, vincent@codeagain.com, agustinfalco.11@gmail.com, nabsul@outlook.com, blakemealey@gmail.com, maedahbatool@gmail.com, bret@brethudson.com, matt.j.straka@gmail.com, mr@jasongullickson.com, a@f3d0r.com, gaspar.garcia09@gmail.com, jourdandiskin@gmail.com, signup+npm@pieparker.com, korevec@gmail.com, dominik.ferber@gmail.com, healeycodes@gmail.com, henry.brophy@vercel.com, clbrouwers@gmail.com, gdborton@gmail.com, jeffrey@vercel.com, denizk@gmail.com, simulcik.miro@gmail.com, domeccleston@gmail.com, hassan4709@gmail.com, rich@vercel.com, thexrayone@icloud.com, gkaragkiaouris2@gmail.com, geovanisouza92@gmail.com, dglsparsons@gmail.com, blweiner@gmail.com, infra+release@vercel.com, southpolesteve@gmail.com, matheus.frndes@gmail.com, igor@klopov.com, naoyuki.kanezawa@gmail.com, nathan@tootallnate.net, rauchg@gmail.com, tim@timneutkens.nl, javier.velasco86@gmail.com, hello@evilrabb.it, kdy.1997.dev@gmail.com, g@shud.in, steven@ceriously.com, team@zeit.co, luc.leray@gmail.com, npm@mark.gl, artzbitz@gmail.com, paulogdemitri@gmail.com, ana.trajkovska2015@gmail.com, timer150@gmail.com, franco@studiofreight.com, jj@jjsweb.site, luisito453@gmail.com, mail@mcs.dev, william@bbi.studio, ragojosefrancisco@gmail.com, guybedford@gmail.com, skllcrn@zeit.co, janicklasralph036@gmail.com, atcastle@gmail.com, shubhie@gmail.com, houssein.djirdeh@gmail.com, gbmonaco@google.com, josefrancisco.verdu@gmail.com, prateek89born@gmail.com, jan.krems@gmail.com, jared@palmer.net, g.cobben@gmail.com, shu@chibicode.com, nazareno@basement.studio, samko9522@gmail.com, curciobel@gmail.com, hank@vercel.com, lrobinson2011@gmail.com, lsimon@commoner.com, julianbenegas99@gmail.com, rizwana.akmal@hotmail.com, tobias.koppers@googlemail.com, haltaffer@gmail.com, github.wolle404@gmail.com, lapapelera@gmail.com, ismaelrumzan@gmail.com, jrshoch@gmail.com, mitchellbwright@gmail.com, mrmckeb.npm@outlook.com, npm-public@qfox.nl, tim@creationix.com, inbox@huozhi.im, christina@vercel.com, ktcarter09@gmail.com, dev@padmaia.rocks, delbabrown@gmail.com, joshuadgon@gmail.com, stevensteel97@gmail.com, gsandhu@csumb.edu, dbredvick@gmail.com, mindrun@icloud.com, 
babel-tape-runner: wavded@gmail.com, 
karma-junit-reporter: dignifiedquire@gmail.com, vojta.jina+npm@gmail.com, mark@zzo.com, 
inject-loader: desk+npm@pixelbloom.com, 
estraverse: nicholas@nczconsulting.com, npm@michael.ficarra.me, utatane.tea@gmail.com, 
browserify-istanbul: iam@alexindigo.com, devongovett@gmail.com, 
gulp-sequence: admin@zensh.com, 
gulp-stylus: me@slacy.me, 
consolidate: niftylettuce@gmail.com, tj@vision-media.ca, brian.woodward@gmail.com, ruben@bridgewater.de, npm@titanism.com, 
gulp-cached: contact@wearefractal.com, ericbombhax@gmail.com, 
gulp-gh-pages: micheal@visionmasterdesigns.com, snnskwtnb@gmail.com, 
gulp-rimraf: robrich@robrich.org, 
nib: tj@vision-media.ca, slang800@gmail.com, 
serialport: wizard@roborooter.com, headhipster@hipsterbrown.com, 
phantomjs-polyfill: tom.james.watson@googlemail.com, 
knex: tgriesser10@gmail.com, simonliden94@gmail.com, mikael.lepisto@vincit.com, iselwin@gmail.com, olivier.cavadenti@gmail.com, 
null-loader: sheo13666q@gmail.com, tobias.koppers@googlemail.com, mail@johannesewald.de, bebraw@gmail.com, eric@smarterspam.com, michael.ciniawsky@gmail.com, sean.larkin@cuw.edu, 
del-cli: sindresorhus@gmail.com, 
electron-prebuilt: to.jlord@gmail.com, zeke@sikelianos.com, electron@github.com, kevinsawicki@gmail.com, dave.des@gmail.com, zcbenz@gmail.com, mathiasbuus@gmail.com, max@maxogden.com, 
gulp-webpack: sindresorhus@gmail.com, kyle@dontkry.com, 
precommit-hook: rtrott@gmail.com, quitlahok@gmail.com, 
selenium-webdriver: titusfortner@gmail.com, jmleyba@gmail.com, tomer@corevo.io, dhaeffner@gmail.com, sri_harsha509@hotmail.com, david.burns@theautomatedtester.co.uk, diemol@gmail.com, 
precss: jonathantneal@hotmail.com, 
pegjs: david@majda.cz, futagoza.ryuu@gmail.com, 
map-stream: nopersonsmodules@gmail.com, 
ink-docstrap: me@terryweiss.net, luke.a.page@gmail.com, 
nomnom: npm@npmjs.com, 
gulp-htmlmin: brian.woodward@gmail.com, github@sellside.com, snnskwtnb@gmail.com, 
load-grunt-config: code@firstandthird.com, mail@solomon.if.ua, 
ape-reporting: okunishinishi@gmail.com, 
grunt-mocha-istanbul: gahgneh@gmail.com, 
sprintf-js: hello@alexei.ro, 
ajv: hello@blakeembrey.com, e.poberezkin@me.com, 
grunt-webpack: sheo13666q@gmail.com, tobias.koppers@googlemail.com, mail@johannesewald.de, npm@tschinder.de, 
readline-sync: AnSeki.aff@gmail.com, 
gulp-install: joakim@beng.se, 
camelcase: sindresorhus@gmail.com, 
broccoli-ember-hbs-template-compiler: me@rwjblue.com, stefan.penner@gmail.com, toranb@gmail.com, 
dependency-check: hello@blakeembrey.com, pelle@kodfabrik.se, max@maxogden.com, 
gulp-streamify: nfroidure@elitwork.com, 
opener: domenic@domenicdenicola.com, 
hiredis: pcnoordhuis@gmail.com, janerik@fnordig.de, 
gulp-zip: sindresorhus@gmail.com, 
grunt-sass: sindresorhus@gmail.com, xzyfer@gmail.com, 
errorhandler: fishrock123@rocketmail.com, tj@vision-media.ca, doug@somethingdoug.com, jonathanrichardong@gmail.com, shtylman@gmail.com, 
amqplib: mikeb@squaremobius.net, stephen.cresswell@gmail.com, 
sinon-as-promised: bvdrucker@gmail.com, 
grunt-autoprefixer: dima.nikitenko@gmail.com, 
npmlog: fritzy@github.com, darcy@darcyclarke.me, ruyadorno@hotmail.com, quitlahok@gmail.com, gar+npm@danger.computer, luke@lukekarrys.com, 
redbox-react: david@excellenteasy.com, max@maxlielje.co, 
gulp-jade: timothygu99@gmail.com, forbes@lindesay.co.uk, blaine.bublitz@gmail.com, 
babel-plugin-transform-react-remove-prop-types: joe.lencioni@gmail.com, olivier.tassinari@gmail.com, 
gulp-karma: lazdnet@gmail.com, 
sequelize: janzeh@gmail.com, me@danieldurante.com, mick.kasper.hansen@gmail.com, sascha@depold.com, felix.b@outlook.com, sushantdhiman@outlook.com, erikseliger@me.com, papb1996@gmail.com, 
chance: mail@victorquinn.com, 
levelup: dev@vincentweevers.nl, r@va.gg, ralphtheninja@riseup.net, 
canvas: kangax@gmail.com, rauchg@gmail.com, linus@folkdatorn.se, nathan@tootallnate.net, d@domenic.me, tj@vision-media.ca, zbbjornson@gmail.com, caleb@chearon.net, 
nightwatch: david.burns@theautomatedtester.co.uk, beatfactor@hotmail.com, 
jscoverage: kate.sf@taobao.com, zhengxinlin@gmail.com, kate.sf@taobao.com, zhengxinlin@gmail.com, 
markdown: ash.berlin@gmail.com, dominic.baggott@gmail.com, 
prismjs: nicole@stubbornella.org, lea@verou.me, ryan.dy@gmail.com, vinsonchuong@gmail.com, gpleiss@gmail.com, jamesorodig@gmail.com, golmote@gmail.com, mitchi5000.ms@googlemail.com, 
stylelint-config-standard: stephen@netweb.com.au, npm@richardhallows.com, aleks@hudochenkov.com, 
xmlhttprequest: dan@driverdan.com, 
electron: electron@github.com, info@electronjs.org, 
level: dev@vincentweevers.nl, r@va.gg, ralphtheninja@riseup.net, 
oauth: ciaranj@gmail.com, 
connect-livereload: andi.neck@intesso.com, 
karma-remap-istanbul: stephencavaliere@gmail.com, juszkiewiczm@gmail.com, mharnos@gmail.com, 
coffee-loader: sheo13666q@gmail.com, tobias.koppers@googlemail.com, mail@johannesewald.de, 
grunt-notify: dylang@gmail.com, 
ioredis: i@zihua.li, ioredis-robot@zihua.li, 
escape-string-regexp: sindresorhus@gmail.com, 
testling: ljharb@gmail.com, substack@gmail.com, 
css: antshort@gmail.com, clint@anotherway.co.za, me@conradz.com, ian@ianstormtaylor.com, jonathanrichardong@gmail.com, jonathanrichardong@gmail.com, simon.lydell@gmail.com, m@moox.io, nicolasgallagher@gmail.com, alexsexton@gmail.com, tj@vision-media.ca, 
grunt-env: jsoverson@gmail.com, stephane.bachelier@gmail.com, 
app-root-path: npm@rchy.net, 
koa-bodyparser: dead_horse@qq.com, fengmk2@gmail.com, 
regenerator-runtime: ben@benjamn.com, 
inflection: ben@dreamerslab.com, p.kuen@cloudacy.com, 
babel-preset-airbnb: opensource@airbnb.com, joe.lencioni@gmail.com, noratarano@gmail.com, josh@goatslacker.com, ljharb@gmail.com, tosharmila@gmail.com, 
hammerjs: arschmitz@gmail.com, j.tangelder@gmail.com, 
metalsmith: npm@andrewgoodricke.com, ian@ianstormtaylor.com, dominic@dbarnes.info, andrewm.bpi@gmail.com, kevin.van.lierde@gmail.com, 
karma-html2js-preprocessor: dignifiedquire@gmail.com, vojta.jina+npm@gmail.com, mark@zzo.com, 
broccoli-funnel: npm@hjdivad.com, me@rwjblue.com, stefan.penner@gmail.com, 
fsevents: pip@pipobscure.com, paul@paulmillr.com, 
json-stringify-safe: i@izs.me, andri@dot.ee, 
object.assign: ljharb@gmail.com, 
elasticsearch: tommydelved@gmail.com, jon@jbudz.me, olson.lukas@gmail.com, email@spalger.com, tylersmalley@me.com, 
methods: tj@vision-media.ca, jonathanrichardong@gmail.com, jonathanrichardong@gmail.com, doug@somethingdoug.com, 
codemirror: marijnh@gmail.com, 
istanbul-harmony: fengmk2@gmail.com, 
send: doug@somethingdoug.com, 
gulp-inject: joakim@beng.se, npm@veeck.de, 
gulp-webserver: schickling.j@gmail.com, 
websocket: theturtle32@gmail.com, 
gaze: alex.gorbatchev@gmail.com, josh@6bit.com, kyle@dontkry.com, 
ssh2: mscdex@mscdex.net, 
portfinder: erik.trom.github@gmail.com, charlie.robbins@gmail.com, 
testem: airportyh@gmail.com, johannes.wuerbach@googlemail.com, stefan.penner@gmail.com, step2yeung@outlook.com, 
gulp-coffeelint: jan@janraasch.com, 
parse5: me@rreverser.com, tituswormer@gmail.com, me@feedic.com, ifaaan@gmail.com, 
sax: i@izs.me, 
grunt-mocha: ben@byk.im, opensource@disqus.com, miyashiro.kelly@gmail.com, tailofthesun@gmail.com, 
figlet: patorjk@gmail.com, 
karma-coveralls: snowball@defpixel.com, 
eslint-plugin-filenames: github@stefanlau.com, 
gulp-rev: sindresorhus@gmail.com, 
chokidar-cli: elan.shanker+npm@gmail.com, kimmo.brunfeldt+public@gmail.com, paul@paulmillr.com, heikki.pora@gmail.com, 
escape-html: doug@somethingdoug.com, tj@vision-media.ca, 
karma-coffee-preprocessor: vojta.jina+npm@gmail.com, mark@zzo.com, dignifiedquire@gmail.com, 
cron: jodevsa@gmail.com, nicholas.j.campbell@gmail.com, 
bootstrap-sass: getbootstrap@gmail.com, markdotto@gmail.com, xhmikosr@gmail.com, glex.spb@gmail.com, 
parallelshell: darkguy2008@gmail.com, paulpflugradt@googlemail.com, npm@keithcirkel.co.uk, 
reselect: dan.abramov@gmail.com, timdorr@timdorr.com, threehams@gmail.com, faassen@startifact.com, node-gyp: r@va.gg, build@iojs.org, 
l_bannard@yahoo.co.uk, alexr.3165@gmail.com, mark.erikson@gmail.com, 
command-line-args: 75pound@gmail.com, 
karma-script-launcher: dignifiedquire@gmail.com, vojta.jina+npm@gmail.com, mark@zzo.com, 
wiredep: cam@cameronspear.com, eddie+npm@eddiemonge.com, contact@ruyadorno.com, sawchuk@gmail.com, 
onchange: hello@blakeembrey.com, admin@stephenbelanger.com, 
grunt-contrib-requirejs: tyler@sleekcode.net, cowboy@rj3.net, kyle@dontkry.com, vlad@vladikoff.com, sindresorhus@gmail.com, jellyes2@gmail.com, 
detect-port: fengmk2@gmail.com, xudafeng@126.com, zic.zhu@gmail.com, 
mocha-jsdom: rico@ricostacruz.com, 
mocha-istanbul: peimei@ya.ru, searls@gmail.com, 
gulp-angular-templatecache: andersson.mickel@gmail.com, 
raf: chris@neversaw.us, christian.tegner@gmail.com, 
pretty-bytes: sindresorhus@gmail.com, 
node.extend: ben@dreamerslab.com, ljharb@gmail.com, 
vinyl-paths: sindresorhus@gmail.com, 
npm-check-updates: raine@cybersemics.org, tomas@cloudcraft.co, 
jit-grunt: shotaro.tsubouchi@gmail.com, 
mqtt: hello@matteocollina.com, adamvrr+npm@gmail.com, yoseph.maguire@gmail.com, 
warning: jn.martinez110@gmail.com, 
postcss-nested: andrey@sitnik.ru, 
vuex: yyx990803@gmail.com, kia.king.08@gmail.com, ktsn55@gmail.com, guillaume.b.chau@gmail.com, 
tsd: sindresorhus@gmail.com, sam.verschueren@gmail.com, 
global: code@legitimatesounding.com, matt@mattesch.info, raynos2@gmail.com, 
chai-enzyme: ayrton.decraene@gmail.com, hi@vesln.com, 
numeral: adamwdraper@gmail.com, 
argx: okunishinishi@gmail.com, 
react-transform-catch-errors: me@thejameskyle.com, dan.abramov@gmail.com, 
change-case: hello@blakeembrey.com, 
serve: marta.hawkins@gmail.com, hello@kylieis.online, chloectedder@gmail.com, pb.to@icloud.com, daniel.campbell@vercel.com, arian.daneshvar@vercel.com, email@seiya.me, alasdair.monk@gmail.com, sam.selikoff@gmail.com, dl.carter00@gmail.com, me@baruchadi.com, elijah@elijahcobb.com, aaorris@gmail.com, dombusser@gmail.com, ryanto@gmail.com, npm@nathanhammond.com, snokohn@yahoo.com, johnphammail@gmail.com, tknickman@gmail.com, andrew.gadzik@vercel.com, thom@thomcrowe.com, yanick.belanger@yahoo.com, ecklf@icloud.com, amy.burns87@gmail.com, malte.ubl@gmail.com, balazs4web@gmail.com, casey.gowrie@vercel.com, samuel.foster@vercel.com, swarnavasengupta@gmail.com, lydiahallie.dev@gmail.com, ethan@arrowood.dev, kwon.ohjoong@gmail.com, kakadiadarpan@gmail.com, amanmittal.work@gmail.com, endangeredmassa@gmail.com, nick.tracey@vercel.com, wizard@roborooter.com, gal@spitfire.co.il, liam.crowter@vercel.com, greg.soltis@vercel.com, epallerols@vercel.com, me@domysee.com, natewienert@gmail.com, adrian@op74.net, steph.dietz@vercel.com, gudmundur.bjarni@gmail.com, marc@marcgreenstock.com, vincent@codeagain.com, agustinfalco.11@gmail.com, nabsul@outlook.com, blakemealey@gmail.com, maedahbatool@gmail.com, bret@brethudson.com, matt.j.straka@gmail.com, mr@jasongullickson.com, a@f3d0r.com, gaspar.garcia09@gmail.com, jourdandiskin@gmail.com, signup+npm@pieparker.com, korevec@gmail.com, dominik.ferber@gmail.com, healeycodes@gmail.com, henry.brophy@vercel.com, clbrouwers@gmail.com, gdborton@gmail.com, jeffrey@vercel.com, denizk@gmail.com, simulcik.miro@gmail.com, domeccleston@gmail.com, hassan4709@gmail.com, rich@vercel.com, thexrayone@icloud.com, gkaragkiaouris2@gmail.com, geovanisouza92@gmail.com, dglsparsons@gmail.com, blweiner@gmail.com, infra+release@vercel.com, southpolesteve@gmail.com, matheus.frndes@gmail.com, igor@klopov.com, naoyuki.kanezawa@gmail.com, nathan@tootallnate.net, rauchg@gmail.com, tim@timneutkens.nl, javier.velasco86@gmail.com, hello@evilrabb.it, kdy.1997.dev@gmail.com, g@shud.in, steven@ceriously.com, team@zeit.co, luc.leray@gmail.com, npm@mark.gl, artzbitz@gmail.com, paulogdemitri@gmail.com, ana.trajkovska2015@gmail.com, timer150@gmail.com, franco@studiofreight.com, jj@jjsweb.site, luisito453@gmail.com, mail@mcs.dev, william@bbi.studio, ragojosefrancisco@gmail.com, guybedford@gmail.com, skllcrn@zeit.co, janicklasralph036@gmail.com, atcastle@gmail.com, shubhie@gmail.com, houssein.djirdeh@gmail.com, gbmonaco@google.com, josefrancisco.verdu@gmail.com, prateek89born@gmail.com, jan.krems@gmail.com, jared@palmer.net, g.cobben@gmail.com, shu@chibicode.com, nazareno@basement.studio, samko9522@gmail.com, curciobel@gmail.com, hank@vercel.com, lrobinson2011@gmail.com, lsimon@commoner.com, julianbenegas99@gmail.com, rizwana.akmal@hotmail.com, tobias.koppers@googlemail.com, haltaffer@gmail.com, github.wolle404@gmail.com, lapapelera@gmail.com, ismaelrumzan@gmail.com, jrshoch@gmail.com, mitchellbwright@gmail.com, mrmckeb.npm@outlook.com, npm-public@qfox.nl, tim@creationix.com, pull-stream: dominic.tarr@gmail.com, inbox@huozhi.im, christina@vercel.com, ktcarter09@gmail.com, dev@padmaia.rocks, delbabrown@gmail.com, dirty-chai: josh@6bit.com, 
joshuadgon@gmail.com, stevensteel97@gmail.com, gsandhu@csumb.edu, dbredvick@gmail.com, mindrun@icloud.com, arunoda.susiripala@gmail.com, 
michael.williams@enspiral.com, andre+npm@staltz.com, whimful@gmail.com, harry.sarson@hotmail.co.uk, 
xmlbuilder: oozcitak@gmail.com, 
autoprefixer-core: andrey@sitnik.ru, 
bl: hello@matteocollina.com, r@va.gg, 
eslint-config-standard-react: john@hiesey.com, bcomnes@gmail.com, feross@feross.org, flettre@gmail.com, linus@folkdatorn.se, mathiasbuus@gmail.com, jprichardson@gmail.com, w@tson.dk, raynos2@gmail.com, toddbluhm@gmail.com, pelle@kodfabrik.se, dignifiedquire@gmail.com, secoif@gmail.com, cesarandreu@gmail.com, dcposch@dcpos.ch, 
babel-preset-es2015-node4: hallo@jonasbach.de, 
helmet: evilpacket@gmail.com, me@evanhahn.com, 
livescript: z@georgezahariev.com, 
leaflet: agafonkin@gmail.com, yohanboniface@free.fr, ivan@sanchezortega.es, per@liedman.net, andrew.cherniavskii@gmail.com, 
download: snnskwtnb@gmail.com, kevinmartensson@gmail.com, npm@silverwind.io, 
redux-devtools: dan.abramov@gmail.com, nbierema@gmail.com, timdorr@timdorr.com, zalmoxisus@gmail.com, 
underscore-plus: atom@github.com, ogle.ben@gmail.com, kevinsawicki@gmail.com, maxbrunsfeld@gmail.com, matt@colyer.name, nathan@github.com, 
nedb: louis.chatriot@gmail.com, 
systemjs-builder: guybedford@gmail.com, 
connect-redis: jain_chirag04@yahoo.com, tj@vision-media.ca, wavded@gmail.com, 
redux-saga: mateuszburzynski@gmail.com, yelouafi@gmail.com, 
postcss-reporter: david.dave.clark@gmail.com, andrey@sitnik.ru, 
cli: cohara87@gmail.com, 
travis-cov: hi@alexanderseville.com, 
broccoli: joliss42@gmail.com, thoov7@gmail.com, me@rwjblue.com, stefan.penner@gmail.com, oli.griffiths@me.com, 
jsdom-global: dropbox@ricostacruz.com, 
fs-plus: ogle.ben@gmail.com, matt@colyer.name, nathan@github.com, kevinsawicki@gmail.com, lee@lee-dohm.com, as-cii@github.com, ian.olsen@gmail.com, atom@github.com, ungb@github.com, 
simple-git: steve@mydev.co, bcryptjs: dcode@dcode.io, 
simple-git@mydev.co, 
jszip: d.duponchel@gmail.com, calvin.metcalf@gmail.com, npm@website.stuartk.com, 
slug: rtrott@gmail.com, 
restler: dan@danwebb.net, andrewdyoung@gmail.com, ben@marvell-consulting.com, 
argparse: vitaly@rcdesign.ru, 
shx: ntfschr@gmail.com, freitagbr@gmail.com, 
gulp-flatten: artem.medeusheyev@gmail.com, 
prettyjson: rafeca@gmail.com, 
grunt-open: jsoverson@gmail.com, 
gulp-conflict: joakim@beng.se, 
csv: david@adaltas.com, 
compression-webpack-plugin: sheo13666q@gmail.com, tobias.koppers@googlemail.com, mail@johannesewald.de, 
forever: jcrugzz@gmail.com, me@jeffsu.com, charlie.robbins@gmail.com, bradley.meck@gmail.com, iselwin@gmail.com, 
selenium-server: me@arty.name, eugene@noblesamurai.com, 
fstream: fritzy@github.com, darcy@darcyclarke.me, ruyadorno@hotmail.com, quitlahok@gmail.com, gar+npm@danger.computer, luke@lukekarrys.com, 
exorcist: bvdrucker@gmail.com, thlorenz10@gmail.com, 
image-size: npm@netroy.in, 
gulp-tag-version: npm@ikari.pl, 
json5: jordanbtucker@gmail.com, aseem.kishore@gmail.com, 
json-stable-stringify: mail@substack.net, 
extend-shallow: blaine.bublitz@gmail.com, github@sellside.com, 
karma-phantomjs-shim: tim.schaub@gmail.com, 
jsonschema: aaa@bzfx.net, tom@degrunt.nl, 
minami: nijikokun@gmail.com, 
jspm: guybedford@gmail.com, 
deasync: wenfred@gmail.com, 
flux: tay.yang.shun@gmail.com, opensource+npm@fb.com, npm@kyldvs.com, 
hoist-non-react-statics: mcridgway@gmail.com, 
expresso: tj@vision-media.ca, kkaefer@gmail.com, 
touch: i@izs.me, 
replace: almaclaine@gmail.com, 
np: sindresorhus@gmail.com, sam.verschueren@gmail.com, itaisteinherz@gmail.com, 
tiny-lr: hawker.jordan@gmail.com, kyle@dontkry.com, daniel.mickael@gmail.com, 
rollup-plugin-json: guybedford@gmail.com, lukas.taegert@tngtech.com, richard.a.harris@gmail.com, andrew@shellscape.org, 
resolve-url-loader: npm@bholloway.com, 
memory-fs: tobias.koppers@googlemail.com, 
fbjs: paul@oshannessy.com, npm@eli-white.com, yungsters@gmail.com, opensource+npm@fb.com, joesavona@fb.com, npm@sophiebits.com, smart.cat4146@fastmail.com, jon@jonjanzen.com, 
eslint-watch: crouska@gmail.com, 
strip-json-comments: sindresorhus@gmail.com, 
image-webpack-loader: thomas.coopman@gmail.com, 
dox: tj@vision-media.ca, me@evindor.com, chiper@chipersoft.com, 
traceur: johnjbarton@johnjbarton.com, erik.arvidsson@gmail.com, 
text-table: mail@substack.net, 
node-watch: yuanchuan23@gmail.com, intervalia@gmail.com, 
gulp-csso: beneb.info@gmail.com, rdvornov@gmail.com, 
finalhandler: doug@somethingdoug.com, 
child-process-promise: austin.kell47@gmail.com, pierceydylan@gmail.com, ml.rawlings@gmail.com, psteeleidem@ebay.com, pnidem@gmail.com, 
pre-git: gleb.bahmutov@gmail.com, 
pinkie-promise: floatdrop@gmail.com, 
read: fritzy@github.com, i@izs.me, darcy@darcyclarke.me, ruyadorno@hotmail.com, quitlahok@gmail.com, gar+npm@danger.computer, luke@lukekarrys.com, 
grunt-ts: bartvanderschoor@gmail.com, basaratali@gmail.com, viralidealogue@gmail.com, malachi@nexussays.com, steve.ognibene@outlook.com, 
osenv: fritzy@github.com, darcy@darcyclarke.me, ruyadorno@hotmail.com, quitlahok@gmail.com, gar+npm@danger.computer, luke@lukekarrys.com, 
log-symbols: sindresorhus@gmail.com, 
grunt-contrib-htmlmin: cowboy@rj3.net, jellyes2@gmail.com, kyle@dontkry.com, sindresorhus@gmail.com, tyler@sleekcode.net, vlad@vladikoff.com, xhmikosr@gmail.com, 
liftoff: sttk.xslet@gmail.com, blaine.bublitz@gmail.com, yo@contra.io, tyler@sleekcode.net, 
three: info@mrdoob.com, michael.herzog@human-interactive.org, 
sprintf: moritz@mpeters.biz, 
angular-ui-router: nate.abele@gmail.com, christopherthielen@ikkyikkyikkypikangzoopboing.com, 
hogan.js: jacobthornton@gmail.com, sayrer@gmail.com, 
grunt-coveralls: pimterry@gmail.com, 
nodegit: tim@tabdeveloper.com, johnhaley81@gmail.com, maxkorp@8bytealchemy.com, mike@pagesofinterest.net, twwanek@gmail.com, ianh@axosoft.com, 
grunt-jasmine-node: s9tpepper@apache.org, 
ember-cli-sass: simon.wade@gmail.com, stefan.penner@gmail.com, melaniersumner@gmail.com, 
randomstring: elias.klughammer@me.com, 
grunt-banner: matt@veryfizzyjelly.com, 
virtual-dom: matt@mattesch.info, 
grunt-replace: afalduto@gmail.com, 
tape-run: julian@juliangruber.com, 
tv4: luffgd@gmail.com, bartvanderschoor@gmail.com, 
ecstatic: josh.holbrook@gmail.com, 
redux-actions: acdlite@me.com, me@matthewslipper.com, tim@cheung.io, v.alvarez312@gmail.com, 
phantom: findamir@gmail.com, 
autod: dead_horse@qq.com, 
beefy: dlmanning@me.com, chris@neversaw.us, 
script-loader: sheo13666q@gmail.com, tobias.koppers@googlemail.com, mail@johannesewald.de, michael.ciniawsky@gmail.com, wiens.joshua@gmail.com, eric@smarterspam.com, sean.larkin@cuw.edu, 
blue-tape: gorgi.kosev@gmail.com, 
eslint-config-defaults: me@ericbaer.com, 
unexpected: sune@we-knowhow.dk, andreaslindpetersen@gmail.com, alex@alexjeffburke.com, gustavnikolaj@gmail.com, joelmukuthu@gmail.com, munter@fumle.dk, 
jison: zack.carter@gmail.com, 
url-join: jonkoops@gmail.com, jfromaniello@gmail.com, 
jslint: okuryu@okuryu.com, me@reidburke.com, smikes@cubane.com, 
grunt-npm: vojta.jina@gmail.com, 
bytes: tj@vision-media.ca, doug@somethingdoug.com, 
must: andri@dot.ee, 
live-server: tapiovierros@gmail.com, 
pretty-hrtime: robrich@robrich.org, 
convert-source-map: thlorenz10@gmail.com, 
highland: caolan.mcmahon@gmail.com, jerome.wagner@m4x.org, victorvu2001@gmail.com, 
googleapis: justin.beckwith@gmail.com, node-team-npm+wombot@google.com, 
parseurl: doug@somethingdoug.com, 
object-path: m@mario.fyi, 
findup-sync: sttk.xslet@gmail.com, blaine.bublitz@gmail.com, cowboy@rj3.net, tyler@sleekcode.net, 
needle: tomas@forkhq.com, 
get-stdin: sindresorhus@gmail.com, 
assert-plus: todd.whiteman@joyent.com, kusorbox@gmail.com, wpreul@gmail.com, michael.hicks@joyent.com, bahamat@digitalelf.net, tyler.chameroy@joyent.com, dayne.buell@joyent.com, pmooney@pfmooney.com, mcavage@gmail.com, alex@cooperi.net, 
cucumber: aslak.hellesoy@gmail.com, charles.w.rudolph@gmail.com, cukebot@cucumber.io, jb@jbpros.com, matt@mattwynne.net, tooky@cucumber.io, 
doctoc: thlorenz10@gmail.com, andrewsmith@alumni.stanford.edu, 
copyfiles: calvin.metcalf@gmail.com, 
react-select: jed.watson@me.com, briandavidvaughn@gmail.com, cc.lee@live.com.au, mitchell@hamil.town, automation+react-select@thinkmill.com.au, 
grunt-gh-pages: tim.schaub@gmail.com, 
zombie: assaf@labnotes.org, jano@dimaion.com, forbes@lindesay.co.uk, matt.lavin@gmail.com, 
angular-cli: devops+npm@angular.io, hansl@google.com, 
mobx: fredy.c@seznam.cz, mweststrate@gmail.com, capajj@gmail.com, login@jilles.me, mail@andykog.com, xaviergonz@gmail.com, 
verb: anders.d.johnson.developer@gmail.com, github@sellside.com, brian.woodward@gmail.com, 
grunt-contrib-yuidoc: tyler@sleekcode.net, cowboy@rj3.net, kyle@dontkry.com, vlad@vladikoff.com, sindresorhus@gmail.com, jellyes2@gmail.com, 
npm-watch: mooster@42at.com, johnwanderson@gmail.com, glurgle@gmail.com, mez613@gmail.com, 
nwb: jonathan.buchanan@gmail.com, 
passport-oauth: jaredhanson@gmail.com, 
pouchdb: jcoglan@gmail.com, albaherreriasdev@gmail.com, jan@apache.org, dale@arandomurl.com, dale+pouchdb@arandomurl.com, ryan.ramage@gmail.com, gareth@bowenwebdesign.co.nz, john@chesl.es, garren.smith@gmail.com, nolan@nolanlawson.com, calvin.metcalf@gmail.com, willholley@apache.org, 
gulp-gzip: jeremystuckey@gmail.com, 
estraverse-fb: me@rreverser.com, 
require-all: doug@somethingdoug.com, nunojobpinto@gmail.com, felix@debuggable.com, thlorenz@gmx.de, 
atom-package-deps: i@steelbrain.me, landonabney@gmail.com, 
pm2: strzelewicz.alexandre@gmail.com, 
chai-http: chaijs@keithcirkel.co.uk, 
karma-opera-launcher: vojta.jina+npm@gmail.com, mark@zzo.com, dignifiedquire@gmail.com, 
basic-auth: doug@somethingdoug.com, jonathanrichardong@gmail.com, jonathanrichardong@gmail.com, tj@vision-media.ca, 
lerna: hi@henryzoo.com, daniel.stockman@gmail.com, 
thunkify: tj@vision-media.ca, 
react-motion: chenglou92@gmail.com, nik@butenko.me, 
esmangle: utatane.tea@gmail.com, npm@michael.ficarra.me, 
remark: johnotander@gmail.com, tituswormer@gmail.com, 
gulp-wrap: magicaj@gmail.com, snnskwtnb@gmail.com, 
gulp-rollup: maurizio.cas@gmail.com, permutatorem@gmail.com, 
chai-subset: eagleeyes91@gmail.com, 
gulp-jsdoc3: maharshi.sevak@deshaw.com, mlucool@gmail.com, 
gulp-open: me@slacy.me, 
main-bower-files: cknoetschke@gmail.com, trysound@yandex.ru, 
webdriverio: christian@saucelabs.com, christian+webdriverio@saucelabs.com, wim@wswebcreation.nl, 
memdown: dev@vincentweevers.nl, r@va.gg, ralphtheninja@riseup.net, 
blessed: chjjeffrey@gmail.com, 
grunt-saucelabs: code@nparashuram.com, code@r.nparashuram.com, jonahss@gmail.com, sebastiantiedtke@gmail.com, 
sync-request: forbes@lindeay.co.uk, 
gulp-help: chr.montgomery@gmail.com, 
karma-ng-html2js-preprocessor: vojta.jina+npm@gmail.com, mark@zzo.com, dignifiedquire@gmail.com, 
eslint-plugin-vue: yyx990803@gmail.com, public@mysticatea.dev, chrisvfritz@gmail.com, msajnog93@gmail.com, otameshiyo23@gmail.com, 
component-emitter: amjad.masad@gmail.com, antshort@gmail.com, hello@blakeembrey.com, calvin@calv.info, clint@anotherway.co.za, thecoreh@gmail.com, cristiandouce@gmail.com, shtylman@gmail.com, df.creative@gmail.com, dominic@dbarnes.info, forbes@lindesay.co.uk, hughskennedy@gmail.com, ian@ianstormtaylor.com, jonathanrichardong@gmail.com, jonathanrichardong@gmail.com, julian@juliangruber.com, kelonyemitchel@gmail.com, mattmuelle@gmail.com, vendethiel@hotmail.fr, fabian.eichenberger@gmail.com, rauchg@gmail.com, rdsuarez@gmail.com, gstagas@gmail.com, me@stephenmathieson.com, arpad.borsos@googlemail.com, dnfagnan@gmail.com, timaschew@gmail.com, secoif@gmail.com, tj@vision-media.ca, nathan@tootallnate.net, trevorgerhardt@gmail.com, yields@icloud.com, 
mock-require: rlauer@gmail.com, 
on-finished: doug@somethingdoug.com, 
leveldown: dev@vincentweevers.nl, r@va.gg, ralphtheninja@riseup.net, 
xml2json: camilo@buglabs.net, camilo.aguilar@gmail.com, 
gulp-ignore: robrich@robrich.org, 
serve-index: doug@somethingdoug.com, 
to-string-loader: gajus@gajus.com, 
radium: sarah.wright@formidable.com, scott.william.rippey@gmail.com, jpsdriver@gmail.com, yankovalera@gmail.com, valentin.al.georgiev@gmail.com, michael@michaelmerrill.me, sarahmichellemeyer@gmail.com, mariano.martinez@formidable.com, me@carlos.dev, ryanrray@gmail.com, samuelestrella226@gmail.com, ryan@loose-bits.com, admin@formidablelabs.com, ryan@eastridge.me, exogen@gmail.com, becca.bailey@formidable.com, phil@kitten.sh, brianhartz@gmail.com, monet.fulgham@formidable.com, jmcbee1@gmail.com, npm@formidablelabs.com, carbonrobot@gmail.com, hello@manos.im, mansoor@msiddeeq.com, ian@obermillers.com, per@sproutlab.com, alexlande@gmail.com, kyle@kylecesmat.com, mhink1103@gmail.com, tyler@tylerpaulthompson.com, huynh.stefan@gmail.com, lavalle.paula@gmail.com, 
gulp-useref: kempdogg@gmail.com, 
hyperquest: mail@substack.net, julian@juliangruber.com, rod@vagg.org, 
es6-promisify: mikehall314@gmail.com, 
intl: andyearnshaw+npm@gmail.com, caridy@gmail.com, 
debounce: thecoreh@gmail.com, arpad.borsos@googlemail.com, timaschew@gmail.com, antshort@gmail.com, ian@ianstormtaylor.com, clint@anotherway.co.za, cristiandouce@gmail.com, gstagas@gmail.com, rauchg@gmail.com, kelonyemitchel@gmail.com, amjad.masad@gmail.com, trevorgerhardt@gmail.com, julian@juliangruber.com, dnfagnan@gmail.com, dominic@dbarnes.info, df.creative@gmail.com, mattmuelle@gmail.com, nathan@tootallnate.net, yields@icloud.com, me@stephenmathieson.com, rdsuarez@gmail.com, tj@vision-media.ca, secoif@gmail.com, jonathanrichardong@gmail.com, forbes@lindesay.co.uk, calvin@calv.info, shtylman@gmail.com, 
nightmare: brian.dentino@gmail.com, mattmuelle@gmail.com, reinpk@gmail.com, rosshinkley@gmail.com, tools+npm@segment.com, me@stephenmathieson.com, 
flat: hughskennedy@gmail.com, secoif@gmail.com, 
gulp-react: sindresorhus@gmail.com, 
grunt-contrib-imagemin: cowboy@rj3.net, james_please@icloud.com, kevinmartensson@gmail.com, kyle@dontkry.com, sindresorhus@gmail.com, tyler@sleekcode.net, vlad@vladikoff.com, xhmikosr@gmail.com, 
gulp-cli: sttk.xslet@gmail.com, blaine.bublitz@gmail.com, ericbombhax@gmail.com, 
lodash-node: john.david.dalton@gmail.com, mathias@qiwi.be, 
remark-lint: johnotander@gmail.com, tituswormer@gmail.com, 
wd: sebastiantiedtke@gmail.com, jlipps@gmail.com, adam.christian@gmail.com, seb.vincent@gmail.com, 
utils-merge: jaredhanson@gmail.com, 
dot: e.poberezkin@me.com, ldoktorova@gmail.com, 
slash: sindresorhus@gmail.com, 
cpx: star.ctor@gmail.com, 
gulp-typedoc: rogier.schouten@gmail.com, 
koa-compose: aaron.heckmann+github@gmail.com, haoxinst@gmail.com, niftylettuce@gmail.com, julian@juliangruber.com, eivind.fjeldstad@gmail.com, dead_horse@qq.com, me@stephenmathieson.com, tj@vision-media.ca, me@tejas.io, jonathanrichardong@gmail.com, fengmk2@gmail.com, npm@titanism.com, 
grunt-usemin: ruyadorno@hotmail.com, marceloshima@gmail.com, ulisesgascondev@gmail.com, sindresorhus@gmail.com, admin@simonboudrias.com, eddie+npm@eddiemonge.com, addyosmani@gmail.com, mail@michael-kuehnel.de, mehdy.dara.fr@gmail.com, esdoc-es7-plugin: h13i32maru@gmail.com, 
paul.irish@gmail.com, 
html-entities: mdevils@yandex.ru, 
istanbul-coveralls: snnskwtnb@gmail.com, 
fastclick: ftlabs-opensource@ft.com, george.crawford@ft.com, pornel@pornel.net, matt@mattandre.ws, 
gulp-tap: jon.ronnenberg@gmail.com, mario@mgutz.com, 
connect-flash: csv-parse: david@adaltas.com, 
jaredhanson@gmail.com, 
grunt-text-replace: j.h.london.uk@gmail.com, 
bignumber.js: M8ch88l@gmail.com, 
grunt-mocha-phantomjs: jdcataldo@gmail.com, 
babel-plugin-typecheck: charles@codemix.com, 
lazy-cache: brian.woodward@gmail.com, github@sellside.com, 
vue-resource: yyx990803@gmail.com, steffan@schiewe.me, 
redux-mock-store: arnaudbenard13@gmail.com, dmitry.zaets@gmail.com, 
raw-body: doug@somethingdoug.com, jonathanrichardong@gmail.com, 
clear: dave@daveeddy.com, 
amdefine: jrburke@gmail.com, 
http-errors: npm@egeste.net, doug@somethingdoug.com, jonathanrichardong@gmail.com, 
chai-things: ruben.verborgh@gmail.com, 
deep-diff: phillip@flitbit.com, 
mocha-loader: sheo13666q@gmail.com, tobias.koppers@googlemail.com, mail@johannesewald.de, michael.ciniawsky@gmail.com, wiens.joshua@gmail.com, eric@smarterspam.com, tomas.ehrlich@gmail.com, sean.larkin@cuw.edu, jan.kanty.pawelski@gmail.com, 
keypress: nathan@tootallnate.net, 
npm: fritzy@github.com, darcy@darcyclarke.me, ruyadorno@hotmail.com, quitlahok@gmail.com, gar+npm@danger.computer, luke@lukekarrys.com, 
react-docgen: opensource+npm@fb.com, npm@tschinder.de, 
zmq: tj@vision-media.ca, ron@ronkorving.nl, justin.tulloss@gmail.com, 
jasmine-reporters: bloveridge@gmail.com, 
gulp-mocha-phantomjs: ruihu.pvt@gmail.com, 
imagemin-pngquant: denjell@sfosc.org, sindresorhus@gmail.com, kevinmartensson@gmail.com, snnskwtnb@gmail.com, shogosensui@gmail.com, bradbaris@gmail.com, xhmikosr@gmail.com, 
generic-pool: james@bitmechanic.com, james.butler@sandfox.co.uk, josefrancisco.verdu@gmail.com, 
web-component-tester: aomarks@gmail.com, emarquez@google.com, sorvell@google.com, bicknellr@gmail.com, brendan@usergenic.com, admin@polymer-project.org, dfreedm2@gmail.com, kevinpschaaf@gmail.com, justin@fagnani.com, ian@nevir.net, 
gulp-run: cbarrick1@gmail.com, marcandrebinder@gmail.com, 
jscs-jsdoc: mdevils@yandex.ru, zxqfox@gmail.com, 
hubot-test-helper: mtsmfm@gmail.com, 
karma-browserstack-launcher: dignifiedquire@gmail.com, venar303@gmail.com, yvonne@extraonions.ca, rwalch@gmail.com, vojta.jina+npm@gmail.com, mark@zzo.com, 
cli-spinner: boemianrapsodi@gmail.com, 
buffer: feross@feross.org, 
verror: todd.whiteman@joyent.com, kusorbox@gmail.com, wpreul@gmail.com, michael.hicks@joyent.com, bahamat@digitalelf.net, tyler.chameroy@joyent.com, dayne.buell@joyent.com, trentm@gmail.com, dap@cs.brown.edu, josh@sysmgr.org, alex@cooperi.net, cody.mello@joyent.com, kelly.mclaughlin@joyent.com, 
inert: eran@hammer.io, 
tough-cookie: awaterma@awaterma.net, jstash@gmail.com, clint@ruoho.org, 
gitbook-cli: hughr2005+npm@gmail.com, contact@gitbook.com, samypesse@gmail.com, johan.preynat@gmail.com, aymeric@gitbook.com, shne24@gmail.com, 
xhr: naugtur@gmail.com, raynos2@gmail.com, 
defaults: tmpvar@gmail.com, 
supertest-as-promised: nikhil.benesch@gmail.com, 
gulp-ruby-sass: sindresorhus@gmail.com, 
mout: miller@millermedeiros.com, andremiguelcruz@msn.com, me@conradz.com, mail@mathias-paumgarten.com, 
microtime: wade@wades.im, 
flow-copy-source: agentme49@gmail.com, 
6to5: sebmck@gmail.com, 
grunt-contrib-compass: tyler@sleekcode.net, cowboy@rj3.net, kyle@dontkry.com, sindresorhus@gmail.com, vlad@vladikoff.com, jellyes2@gmail.com, 
intelli-espower-loader: takuto.wada@gmail.com, azuciao@gmail.com, 
cuid: eric@ericleads.com, 
knox: tj@vision-media.ca, domenic@domenicdenicola.com, 
connect-mongo: jerome.desboeufs@gmail.com, mingchuno@gmail.com, 
findit: mail@substack.net, 
eslint-plugin-ava: sindresorhus@gmail.com, mark@novemberborn.net, 
plist: reinstein.mike@gmail.com, nathan@tootallnate.net, 
after: raynos2@gmail.com, shtylman@gmail.com, 
codacy-coverage: team@codacy.com, rtfrodrigo@gmail.com, 
mocha-jshint: npm@fizkerinc.dk, jp@jonatanpedersen.com, mfbeast@mail.ru, allan@878.dk, a.bubenshchykov@gmail.com, eagleeyes91@gmail.com, mirza.kapetanovic@gmail.com, evgen.filatov@gmail.com, dan@steenbjerg.com, 
eslint-config-xo: sindresorhus@gmail.com, hello@mario-nebl.de, 
gulp-file: ninjabryan@gmail.com, npm@aasselin.com, talk@alexmingoia.com, 
minifyify: me@benng.me, 
tar-fs: mathiasbuus@gmail.com, max@maxogden.com, 
fetch-mock: pimterry@gmail.com, jack@jackfranklin.net, wheresrhys@gmail.com, 
gulp-jsdoc: olivier@webitup.fr, charlie.robbins@gmail.com, 
gulp-spawn-mocha: mail@kenpowers.net, 
node-dir: fshost@yahoo.com, 
grunt-ng-annotate: m.goleb@gmail.com, 
sails: rachaelshaw@treeline.io, mike@balderdash.co, npm@sailsjs.com, eashaw@sailsjs.com, 
eslint-plugin-flow-vars: zertosh@gmail.com, 
showdown: estevao.santos@gmail.com, devyn.stott@gmail.com, 
grunt-jsonlint: brandon.s.ramirez@gmail.com, 
react-intl: holevietlong@gmail.com, seth@bertalotto.net, dinglinjie+npm@gmail.com, caridy@gmail.com, juan@dopazo.me, contact@clarle.com, okuryu@okuryu.com, eferraiuolo@gmail.com, 
js-cookie: klaus.hartl@gmail.com, gravatar@fagnermartins.com, 
figures: sindresorhus@gmail.com, 
draft-js: paul@oshannessy.com, flarnie.npm@gmail.com, opensource+npm@fb.com, npm@sophiebits.com, 
eslint-plugin-json: me@azeemba.com, 
domready: polvero@gmail.com, jacobthornton@gmail.com, 
stack-trace: felix@debuggable.com, hoitz@komola.de, tim@fostle.com, gajus@gajus.com, bniemyjski@gmail.com, kevin@glowacz.info, 
component: trevorgerhardt@gmail.com, jonathanrichardong@gmail.com, secoif@gmail.com, vendethiel@hotmail.fr, clint@anotherway.co.za, timaschew@gmail.com, 
assets-webpack-plugin: kossnocorp@gmail.com, zach.toben@gmail.com, 
jsonlint: zack.carter@gmail.com, 
multiparty: doug@somethingdoug.com, 
vinyl-transform: hughskennedy@gmail.com, 
release-it: lars@webpro.nl, 
preact: allamsetty.anup@gmail.com, hello@preactjs.com, jason@developit.ca, luke@lukeed.com, prateek89born@gmail.com, npm.leah@hrmny.sh, hello@marvinh.dev, solarliner@gmail.com, decroockjovi@gmail.com, sventschui@gmail.com, robertknight@gmail.com, drewigg@gmail.com, 
protobufjs: dcode+npm@dcode.io, dcode+protobufjs@dcode.io, node-team-npm+wombot@google.com, 
loopback: enjoyjava@gmail.com, mbajtoss@gmail.com, r.m.graham@gmail.com, captain@hacksparrow.com, dianahmlau@gmail.com, jerryjoh@us.ibm.com, jgorzinski@gmail.com, 
eslint-plugin-jsdoc: gajus@gajus.com, 
antd: yesmeck@gmail.com, afc163@gmail.com, onlylae@sina.com, scdzwyxst@gmail.com, smith3816@gmail.com, 45808948@qq.com, wasd2144@hotmail.com, xrkffgg@hotmail.com, 1075746765@qq.com, 
snyk: npmjs+snyk-admin@snyk.io, 
firebase: chholland@google.com, hiranya911@gmail.com, operations+plainlogo@firebase.com, feiyang.chen1@gmail.com, node-team-npm+wombot@google.com, 
